30 100
CGTGGGTCACACCGGCAAAACGCATCAACT|AATGTCTGCTGGCCCGGGCGGACATCTGAC
CATTTCAAACGCATCAACTCATTTCTGTAC|TCAACTCATTTCTGTACGCACAGAGGGATT
ACTAATGTCCGATCACGCTTCTTCGCCTCC|AATTCTGTGGTCCTTATCGTTTGGCTCTAA
GTAAACTGAGGATAGAAACGATGCGCCTAA|GGTATATGGCGAGTCTTTCGTTCTAATAGT
GCATGTTCCAGCCGTATGGAAACGCATCAA|AACGCATCAACTCATTTCTGTACGCACAGG
TTCTGTACGCACAGGGATTGCGGAGTCTCC|TCATTTCTGTACGCACAGTGTACGCACAGC
GAGTCACAGCGGAGCCCAATCAATTAGGCC|TGTACGCACAAACGCATCAACTCATTTCTG
CTCATTTCTGTACGCACAGTATGTGACCTG|ACAGCCAAACGCATCAACTCATTTCTGTAC
ATCAACTCATTTCTGTACGCACAGAGGATT|AGTGCCGTCCGGCGCGTGACGTAGGTTTCA
CATCAACTCATTTCTGTACGCACAGAGGGA|TCACACCGGCAAAACGCATCAACTCATTTC
CCGTCCGGCGCGTGACGTAGGTTTCAGCCC|TTAATGACCTGAGGTCACGCAATTATTTCG
AGCCAAACGCATCAACTCATTTCTGTACGC|GCCCTGCCCTAGTGCCGTCCGGCGCGTGAC
GGATCCCGAGATCCCAAACACAGTTGTTAC|GCGTTAACCCAAACGCATCAACTCATTTCT
GATCATAAGTCGTACAGACCCAGAGTCAGG|AAGATTTCGCCATCCGCAGGACTGCGTCGT
CCCTAGTGCCGTCCGGCGCGTGACGTAGGT|TCAGGTAATTAATGACCTGAGGTCACGCAA
GTACGCACAGTATGTGACCTGCAATGGATA|CGCATCAACTCATTTCTGTACGCACAGAGG
ATTTCTGTACGCACAGAGTCCTCGCCACTT|CATACTTAACCTCGGCGAAACGCATCAACT
GCCGTCCGGCGCGTGACGTAGGTTTCAGCC|ATTAATGACCTGAGGTCACGCAATTATTTC
AAACTGAGGATAGAAACGATGCGCCTAATA|TATATGGCGAGTCTTTCGTTCTAATAGTAC
CATCCTATCCTTCATAGGGTCCTAAATCGC|TTCTGTACGCACAGGGATTGCGGAGTCTCC
TGGAAACGCATCAACTCATTTCTGTACGCA|TCTGTACGCACAGGTCAAGCGCCTACTGCA
GGCTAATTGTTCTCGTGCGTCGCGTAGCTT|TACGCACAGAGAAGGATCATAAGTCGTACA
CGCGCAAACGCATCAACTCATTTCTGTACG|GGTATATACGAACGAAAAGCACACAGGAGC
TCCGGATTCCCTCAATGTCTGCTGGCCCGG|CAATTAGGCCGGCTAATTGTTCTCGTGCGT
ATCACGCTTCTTCGCCTCCGAAGACGGCTA|CCTTATCGTTTGGCTCTAAACGCATCAACT
GGATTACGATTTGCGTTGCCACTGAACATT|AGCCTTCTGGCCTTGAGTCACAGCGGAGCC
ATCAACTCATTTCTGTACGCACAGAGAAGG|GCGAATGGGGGGACTGAGTTCTTTGGGTAA
ATCCCGAGATCCCAAACACAGTTGTTACTG|GTTAACCCAAACGCATCAACTCATTTCTGT
GCCACTTGCCAGTAAGACCATAGTGACGTA|ATCAACTCATTTCAAACGCATCAACTCATT
AGCCAATGAGGACGTGGCAGGGGTGCGATC|CACAGTATGTGACCTGCAATGGATACACCG
CCATAGTGACGTAGCAGTTTCCAAACGCAT|GCATCAACTCATTTCTGTACGCACAGAAAC
CAGAGTCCTCGCCACTTGCCAGTAAGACCA|GGCGAAACGCATCAACTCATTTCAAACGCA
AGCAGTTTCCAAACGCATCAACTCATTTCT|TTCTGTACGCACAGAAACGCATCAACTCAT
GCCAAACGCATCAACTCATTTCTGTACGCA|GTGGGATTACGATTTGCGTTGCCACTGAAC
CAGTAAGACCATAGTGACGTAGCAGTTTCC|TTTCAAACGCATCAACTCATTTCTGTACGC
ATGTTCCAGCCGTATGGAAACGCATCAACT|CGCATCAACTCATTTCTGTACGCACAGGTC
CATCAACTCATTTCTGTACGCACAGTGTAC|GAGGACGTGGCAGGGGTGCGATCCCGGCGC
AATTGTTCTCGTGCGTCGCGTAGCTTCATG|CACAGAGAAGGATCATAAGTCGTACAGACC
CACAGTTGTTACTGAAATGGATTAATTCTG|CAACTCATTTCTGTACGCACAGAGTCCTCG
GCATCAACTCATTTCTGTACGCACAGAACT|CAAACACAGTTGTTACTGAAATGGATTAAT
CATTTCTGTACGCACAAACGCATCAACTCA|GCACACAGGAGCGACCGGGAAGCGAATGGG
TGAGGACGTGGCAGGGGTGCGATCCCGGCG|ATGTGACCTGCAATGGATACACCGGGGAAA
GATTGCGGAGTCTCCTTGCCTGTCATAGCG|CAGTGTACGCACAGCATGTTCCAGCCGTAT
CACCTGTATTGCATCCCGTGGTAAACTGAG|GAAGGCCAAGTTGGTGTCGTGGTATATGGC
CTGAGGTCACGCAATTATTTCGGTATATAC|CCTTGCACCTGTATTGCATCCCGTGGTAAA
ACGATTTGCGTTGCCACTGAACATTAACAT|TCTGGCCTTGAGTCACAGCGGAGCCCAATC
GAGGATTCTTAAAGCTACAGAGCCTTCTGG|GGTTTCAGCCCGCGCAAACGCATCAACTCA
ACGCACAGGCTCGGAGCGGGGAGCATGGGA|ATCCTATCCTTCATAGGGTCCTAAATCGCG
CACCGGGGAAACTGTGGGATTACGATTTGC|ATTCTTAAAGCTACAGAGCCTTCTGGCCTT
AGATTTCGCCATCCGCAGGACTGCGTCGTT|CCCTGCACCAGGGAAGTAAGATAAAGCAGA
CAGACCCAGAGTCAGGTAATTAATGACCTG|CGCAGGACTGCGTCGTTGGTGTAAATGCCT
AGTATGTGACCTGCAATGGATACACCGGGG|CTCATTTCTGTACGCACAGAGGATTCTTAA
GCGGACATCTGACAGCCAAACGCATCAACT|CGCGTAGCTTCATGCCCTGCCCTAGTGCCG
ACGGCTAAACGCATCAACTCATTTCTGTAC|ATCAACTCATTTCTGTACGCACAGCAGCAT
TTTCGGTATATACGAACGAAAAGCACACAG|ATCCCGTGGTAAACTGAGGATAGAAACGAT
GGATTCCGGAGCCAATGAGGACGTGGCAGG|TTCTGTACGCACAGTATGTGACCTGCAATG
AACCTCGGCGAAACGCATCAACTCATTTCA|TCATTTCTGTACGCACAAACGCATCAACTC
CGGAGCGGGGAGCATGGGATCCCGAGATCC|CATAGGGTCCTAAATCGCGTTAACCCAAAC
TGTATTGCATCCCGTGGTAAACTGAGGATA|GCCAAGTTGGTGTCGTGGTATATGGCGAGT
GGCAGGGGTGCGATCCCGGCGCCGCCAAAC|GCAATGGATACACCGGGGAAACTGTGGGAT
ATTTCTGTACGCACAAACGCATCAACTCAT|AGCGCCTACTGCACGTGGGTCACACCGGCA
CTGCCCTAGTGCCGTCCGGCGCGTGACGTA|GAGTCAGGTAATTAATGACCTGAGGTCACG
TTCTGTACGCACAGTGTACGCACAGCATGT|AGGGGTGCGATCCCGGCGCCGCCAAACGCA
GTTACTGAAATGGATTAATTCTGTGGTCCT|TTTCTGTACGCACAGAGTCCTCGCCACTTG
GGCGGACATCTGACAGCCAAACGCATCAAC|TCGCGTAGCTTCATGCCCTGCCCTAGTGCC
GCGCCGCCAAACGCATCAACTCATTTCTGT|AAACTGTGGGATTACGATTTGCGTTGCCAC
CGCACAGAAACGCATCAACTCATTTCTGTA|TCCGGAGCCAATGAGGACGTGGCAGGGGTG
GCCGGCTAATTGTTCTCGTGCGTCGCGTAG|CTGTACGCACAGAGAAGGATCATAAGTCGT
ATTCCGGAGCCAATGAGGACGTGGCAGGGG|CTGTACGCACAGTATGTGACCTGCAATGGA
GGATTGCGGAGTCTCCTTGCCTGTCATAGC|ACAGTGTACGCACAGCATGTTCCAGCCGTA
GATTCTTAAAGCTACAGAGCCTTCTGGCCT|TTCAGCCCGCGCAAACGCATCAACTCATTT
TCCTTCATAGGGTCCTAAATCGCGTTAACC|CGCACAGGGATTGCGGAGTCTCCTTGCCTG
GCAGTTTCCAAACGCATCAACTCATTTCTG|TCTGTACGCACAGAAACGCATCAACTCATT
CTGTCATAGCGCAATACTCATACTTAACCT|TCCAGCCGTATGGAAACGCATCAACTCATT
GCCTGTCATAGCGCAATACTCATACTTAAC|GTTCCAGCCGTATGGAAACGCATCAACTCA
GTCGTACAGACCCAGAGTCAGGTAATTAAT|GCCATCCGCAGGACTGCGTCGTTGGTGTAA
ATATACGAACGAAAAGCACACAGGAGCGAC|GGTAAACTGAGGATAGAAACGATGCGCCTA
AAATGGATTAATTCTGTGGTCCTTATCGTT|ACGCACAGAGTCCTCGCCACTTGCCAGTAA
TGTACGCACAAACGCATCAACTCATTTCTG|AGGAGCGACCGGGAAGCGAATGGGGGGACT
ATAGTGACGTAGCAGTTTCCAAACGCATCA|ATCAACTCATTTCTGTACGCACAGAAACGC
ATTCCCTCAATGTCTGCTGGCCCGGGCGGA|AGGCCGGCTAATTGTTCTCGTGCGTCGCGT
GTGCGATCCCGGCGCCGCCAAACGCATCAA|ATACACCGGGGAAACTGTGGGATTACGATT
TACGCACAGAAACGCATCAACTCATTTCTG|ATTCCGGAGCCAATGAGGACGTGGCAGGGG
AGGAGCGACCGGGAAGCGAATGGGGGGACT|ATGCGCCTAATAAAAGCCATGGGTGAGTTG
GATTAATTCTGTGGTCCTTATCGTTTGGCT|CAGAGTCCTCGCCACTTGCCAGTAAGACCA
TTTCTGTACGCACAGGTCAAGCGCCTACTG|TTGCCACTGAACATTAACATCCGGATTCCC
CCCGGCGCCGCCAAACGCATCAACTCATTT|GGGGAAACTGTGGGATTACGATTTGCGTTG
AGCTACAGAGCCTTCTGGCCTTGAGTCACA|CGCAAACGCATCAACTCATTTCTGTACGCA
GGAAACTGTGGGATTACGATTTGCGTTGCC|AAAGCTACAGAGCCTTCTGGCCTTGAGTCA
GTCCGATCACGCTTCTTCGCCTCCGAAGAC|GTGGTCCTTATCGTTTGGCTCTAAACGCAT
GAAACGCATCAACTCATTTCAAACGCATCA|TACGCACAAACGCATCAACTCATTTCTGTA
ATCCGGATTCCCTCAATGTCTGCTGGCCCG|TCAATTAGGCCGGCTAATTGTTCTCGTGCG
TGTACGCACAGAACTAATGTCCGATCACGC|CTGAAATGGATTAATTCTGTGGTCCTTATC
CGGCGCGTGACGTAGGTTTCAGCCCGCGCA|GACCTGAGGTCACGCAATTATTTCGGTATA
TGGCAGGGGTGCGATCCCGGCGCCGCCAAA|TGCAATGGATACACCGGGGAAACTGTGGGA
CTTATCGTTTGGCTCTAAACGCATCAACTC|TGCCAGTAAGACCATAGTGACGTAGCAGTT
AGGACGTGGCAGGGGTGCGATCCCGGCGCC|GTGACCTGCAATGGATACACCGGGGAAACT
ACGCATCAACTCATTTCTGTACGCACAAAC|ACGAACGAAAAGCACACAGGAGCGACCGGG
GTAAATGCCTTGCACCTGTATTGCATCCCG|CTTAGAGCGTCCGAAGGCCAAGTTGGTGTC
GCACGTGGGTCACACCGGCAAAACGCATCA|CTCAATGTCTGCTGGCCCGGGCGGACATCT
TGAGTCACAGCGGAGCCCAATCAATTAGGC|CTGTACGCACAAACGCATCAACTCATTTCT
CAACTCATTTCTGTACGCACAGGGATTGCG|GCATCAACTCATTTCTGTACGCACAGTGTA
CGCCATCCGCAGGACTGCGTCGTTGGTGTA|ACCAGGGAAGTAAGATAAAGCAGACTGCTT
CGCATCAACTCATTTCTGTACGCACAGAGG|CCTAGTGCCGTCCGGCGCGTGACGTAGGTT
GCATCAACTCATTTCTGTACGCACAAACGC|GAACGAAAAGCACACAGGAGCGACCGGGAA
ATTTCTGTACGCACAGGCTCGGAGCGGGGA|ACAGCAGCATCCTATCCTTCATAGGGTCCT
TGACGTAGGTTTCAGCCCGCGCAAACGCAT|GGTCACGCAATTATTTCGGTATATACGAAC
CATCAACTCATTTCAAACGCATCAACTCAT|CAAACGCATCAACTCATTTCTGTACGCACA
CGTGACGTAGGTTTCAGCCCGCGCAAACGC|GAGGTCACGCAATTATTTCGGTATATACGA
TGTACGCACAGAGAAGGATCATAAGTCGTA|CTGAGTTCTTTGGGTAAAGATTTCGCCATC
ACGCATCAACTCATTTCTGTACGCACAGAG|GGGTCACACCGGCAAAACGCATCAACTCAT
GAGGTCACGCAATTATTTCGGTATATACGA|TTGCACCTGTATTGCATCCCGTGGTAAACT
CCAAACGCATCAACTCATTTCTGTACGCAC|TGGGATTACGATTTGCGTTGCCACTGAACA
GCTAATTGTTCTCGTGCGTCGCGTAGCTTC|ACGCACAGAGAAGGATCATAAGTCGTACAG
CAGGAGCGACCGGGAAGCGAATGGGGGGAC|GATGCGCCTAATAAAAGCCATGGGTGAGTT
TGCGTCGCGTAGCTTCATGCCCTGCCCTAG|ATCATAAGTCGTACAGACCCAGAGTCAGGT
AATGGATACACCGGGGAAACTGTGGGATTA|CACAGAGGATTCTTAAAGCTACAGAGCCTT
GAACGAAAAGCACACAGGAGCGACCGGGAA|CTGAGGATAGAAACGATGCGCCTAATAAAA
AGCTTCATGCCCTGCCCTAGTGCCGTCCGG|GTACAGACCCAGAGTCAGGTAATTAATGAC
TAGTGACGTAGCAGTTTCCAAACGCATCAA|TCAACTCATTTCTGTACGCACAGAAACGCA
CAACTCATTTCAAACGCATCAACTCATTTC|ACGCATCAACTCATTTCTGTACGCACAGAG
AACTCATTTCTGTACGCACAAACGCATCAA|GGTCAAGCGCCTACTGCACGTGGGTCACAC
TAATGTCCGATCACGCTTCTTCGCCTCCGA|TTCTGTGGTCCTTATCGTTTGGCTCTAAAC
GTCTGCTGGCCCGGGCGGACATCTGACAGC|TTGTTCTCGTGCGTCGCGTAGCTTCATGCC
CATCAACTCATTTCTGTACGCACAGCAGCA|GTAGCAGTTTCCAAACGCATCAACTCATTT
TTTCTGTACGCACAGAGGGATTCCGGAGCC|AAAACGCATCAACTCATTTCTGTACGCACA
CGGCGCCGCCAAACGCATCAACTCATTTCT|GGAAACTGTGGGATTACGATTTGCGTTGCC
CGATTTGCGTTGCCACTGAACATTAACATC|CTGGCCTTGAGTCACAGCGGAGCCCAATCA
CATCAACTCATTTCTGTACGCACAGGTCAA|ACGATTTGCGTTGCCACTGAACATTAACAT
AGTGCCGTCCGGCGCGTGACGTAGGTTTCA|GTAATTAATGACCTGAGGTCACGCAATTAT
TTCTTTGGGTAAAGATTTCGCCATCCGCAG|GCCGCATCAAGACCCTGCACCAGGGAAGTA
TACGCACAGTATGTGACCTGCAATGGATAC|GCATCAACTCATTTCTGTACGCACAGAGGA
AGGACTGCGTCGTTGGTGTAAATGCCTTGC|TAAGATAAAGCAGACTGCTTAGAGCGTCCG
GCACAGGCTCGGAGCGGGGAGCATGGGATC|CCTATCCTTCATAGGGTCCTAAATCGCGTT
ATTGTTCTCGTGCGTCGCGTAGCTTCATGC|ACAGAGAAGGATCATAAGTCGTACAGACCC
AACGAAAAGCACACAGGAGCGACCGGGAAG|TGAGGATAGAAACGATGCGCCTAATAAAAG
AGAGTCCTCGCCACTTGCCAGTAAGACCAT|GCGAAACGCATCAACTCATTTCAAACGCAT
TTGCACCTGTATTGCATCCCGTGGTAAACT|TCCGAAGGCCAAGTTGGTGTCGTGGTATAT
TAAATCGCGTTAACCCAAACGCATCAACTC|GAGTCTCCTTGCCTGTCATAGCGCAATACT
CATAGCGCAATACTCATACTTAACCTCGGC|GCCGTATGGAAACGCATCAACTCATTTCTG
ACAGACCCAGAGTCAGGTAATTAATGACCT|CCGCAGGACTGCGTCGTTGGTGTAAATGCC
GGGGGACTGAGTTCTTTGGGTAAAGATTTC|GTGAGTTGAATGCCGCATCAAGACCCTGCA
CATCCGCAGGACTGCGTCGTTGGTGTAAAT|AGGGAAGTAAGATAAAGCAGACTGCTTAGA
ATTTCTGTACGCACAGGTCAAGCGCCTACT|GTTGCCACTGAACATTAACATCCGGATTCC
CGTTAACCCAAACGCATCAACTCATTTCTG|CTTGCCTGTCATAGCGCAATACTCATACTT
AAAAGCACACAGGAGCGACCGGGAAGCGAA|GATAGAAACGATGCGCCTAATAAAAGCCAT
CTCATTTCTGTACGCACAAACGCATCAACT|TCAAGCGCCTACTGCACGTGGGTCACACCG
TTAACCTCGGCGAAACGCATCAACTCATTT|ACTCATTTCTGTACGCACAAACGCATCAAC
CCGATCACGCTTCTTCGCCTCCGAAGACGG|GGTCCTTATCGTTTGGCTCTAAACGCATCA
GCGTCGTTGGTGTAAATGCCTTGCACCTGT|AAAGCAGACTGCTTAGAGCGTCCGAAGGCC
GGGTGCGATCCCGGCGCCGCCAAACGCATC|GGATACACCGGGGAAACTGTGGGATTACGA
TGGCCTTGAGTCACAGCGGAGCCCAATCAA|TCATTTCTGTACGCACAAACGCATCAACTC
ATTTCTGTACGCACAGCAGCATCCTATCCT|TCCAAACGCATCAACTCATTTCTGTACGCA
AATACTCATACTTAACCTCGGCGAAACGCA|GAAACGCATCAACTCATTTCTGTACGCACA
GTACGCACAGAACTAATGTCCGATCACGCT|TGAAATGGATTAATTCTGTGGTCCTTATCG
GCAATGGATACACCGGGGAAACTGTGGGAT|CGCACAGAGGATTCTTAAAGCTACAGAGCC
AGCGGAGCCCAATCAATTAGGCCGGCTAAT|ACAAACGCATCAACTCATTTCTGTACGCAC
CAGTTGTTACTGAAATGGATTAATTCTGTG|ACTCATTTCTGTACGCACAGAGTCCTCGCC
AAAGCTACAGAGCCTTCTGGCCTTGAGTCA|CGCGCAAACGCATCAACTCATTTCTGTACG
TGTACGCACAGTATGTGACCTGCAATGGAT|ACGCATCAACTCATTTCTGTACGCACAGAG
ACTCATTTCTGTACGCACAGCAGCATCCTA|AGTTTCCAAACGCATCAACTCATTTCTGTA
GTGGGATTACGATTTGCGTTGCCACTGAAC|CAGAGCCTTCTGGCCTTGAGTCACAGCGGA
GCGGAGTCTCCTTGCCTGTCATAGCGCAAT|GTACGCACAGCATGTTCCAGCCGTATGGAA
ATAAGTCGTACAGACCCAGAGTCAGGTAAT|TTTCGCCATCCGCAGGACTGCGTCGTTGGT
TTCTGTACGCACAGAGGATTCTTAAAGCTA|GGCGCGTGACGTAGGTTTCAGCCCGCGCAA
GCCAATGAGGACGTGGCAGGGGTGCGATCC|ACAGTATGTGACCTGCAATGGATACACCGG
GTTTCCAAACGCATCAACTCATTTCTGTAC|GTACGCACAGAAACGCATCAACTCATTTCT
AATGGGGGGACTGAGTTCTTTGGGTAAAGA|ATGGGTGAGTTGAATGCCGCATCAAGACCC
ATCAACTCATTTCAAACGCATCAACTCATT|AAACGCATCAACTCATTTCTGTACGCACAG
AACTCATTTCTGTACGCACAGGGATTGCGG|CATCAACTCATTTCTGTACGCACAGTGTAC
ACCTGTATTGCATCCCGTGGTAAACTGAGG|AAGGCCAAGTTGGTGTCGTGGTATATGGCG
CGCATCAACTCATTTCTGTACGCACAGAAC|CCAAACACAGTTGTTACTGAAATGGATTAA
CAACTCATTTCTGTACGCACAGAGGATTCT|TGCCGTCCGGCGCGTGACGTAGGTTTCAGC
AATGTCTGCTGGCCCGGGCGGACATCTGAC|TAATTGTTCTCGTGCGTCGCGTAGCTTCAT
CCTTCTGGCCTTGAGTCACAGCGGAGCCCA|TCAACTCATTTCTGTACGCACAAACGCATC
GAATGGGGGGACTGAGTTCTTTGGGTAAAG|CATGGGTGAGTTGAATGCCGCATCAAGACC
CAACTCATTTCTGTACGCACAGAGAAGGAT|GAATGGGGGGACTGAGTTCTTTGGGTAAAG
GTCAAGCGCCTACTGCACGTGGGTCACACC|AACATCCGGATTCCCTCAATGTCTGCTGGC
GGAAACGCATCAACTCATTTCTGTACGCAC|CTGTACGCACAGGTCAAGCGCCTACTGCAC
GTAATTAATGACCTGAGGTCACGCAATTAT|TTGGTGTAAATGCCTTGCACCTGTATTGCA
CTGTACGCACAAACGCATCAACTCATTTCT|CCTACTGCACGTGGGTCACACCGGCAAAAC
CTCGGAGCGGGGAGCATGGGATCCCGAGAT|TTCATAGGGTCCTAAATCGCGTTAACCCAA
CGCATCAACTCATTTCTGTACGCACAGAGA|GAAGCGAATGGGGGGACTGAGTTCTTTGGG
CAGAGAAGGATCATAAGTCGTACAGACCCA|TTTGGGTAAAGATTTCGCCATCCGCAGGAC
TGTACGCACAAACGCATCAACTCATTTCTG|CTACTGCACGTGGGTCACACCGGCAAAACG
GGGGAAACTGTGGGATTACGATTTGCGTTG|TTAAAGCTACAGAGCCTTCTGGCCTTGAGT
CGCACAGAGAAGGATCATAAGTCGTACAGA|GTTCTTTGGGTAAAGATTTCGCCATCCGCA
CACAGGCTCGGAGCGGGGAGCATGGGATCC|CTATCCTTCATAGGGTCCTAAATCGCGTTA
CTGCTGGCCCGGGCGGACATCTGACAGCCA|GTTCTCGTGCGTCGCGTAGCTTCATGCCCT
GCACAGAGGGATTCCGGAGCCAATGAGGAC|CAACTCATTTCTGTACGCACAGTATGTGAC
GCACAGAGTCCTCGCCACTTGCCAGTAAGA|CTCGGCGAAACGCATCAACTCATTTCAAAC
CATTTCTGTACGCACAGAGGATTCTTAAAG|TCCGGCGCGTGACGTAGGTTTCAGCCCGCG
GATCACGCTTCTTCGCCTCCGAAGACGGCT|TCCTTATCGTTTGGCTCTAAACGCATCAAC
AACTCATTTCTGTACGCACAGAGAAGGATC|AATGGGGGGACTGAGTTCTTTGGGTAAAGA
TCGTGCGTCGCGTAGCTTCATGCCCTGCCC|AGGATCATAAGTCGTACAGACCCAGAGTCA
ACTGCACGTGGGTCACACCGGCAAAACGCA|TCCCTCAATGTCTGCTGGCCCGGGCGGACA
TGGGTAAAGATTTCGCCATCCGCAGGACTG|ATCAAGACCCTGCACCAGGGAAGTAAGATA
ACTCATTTCTGTACGCACAGGGATTGCGGA|ATCAACTCATTTCTGTACGCACAGTGTACG
TTTCTGTACGCACAGAACTAATGTCCGATC|GTTACTGAAATGGATTAATTCTGTGGTCCT
GTCGTTGGTGTAAATGCCTTGCACCTGTAT|AGCAGACTGCTTAGAGCGTCCGAAGGCCAA
TCTGTACGCACAGAACTAATGTCCGATCAC|TACTGAAATGGATTAATTCTGTGGTCCTTA
GGGATTCCGGAGCCAATGAGGACGTGGCAG|TTTCTGTACGCACAGTATGTGACCTGCAAT
CTCATTTCTGTACGCACAGAACTAATGTCC|AGTTGTTACTGAAATGGATTAATTCTGTGG
GTTCCAGCCGTATGGAAACGCATCAACTCA|CATCAACTCATTTCTGTACGCACAGGTCAA
TCCAGCCGTATGGAAACGCATCAACTCATT|TCAACTCATTTCTGTACGCACAGGTCAAGC
AAACGCATCAACTCATTTCTGTACGCACAG|ATCCCAAACACAGTTGTTACTGAAATGGAT
CAAACGCATCAACTCATTTCTGTACGCACA|CGTGGGTCACACCGGCAAAACGCATCAACT
CGGTATATACGAACGAAAAGCACACAGGAG|CCGTGGTAAACTGAGGATAGAAACGATGCG
CGCACAGTGTACGCACAGCATGTTCCAGCC|CGATCCCGGCGCCGCCAAACGCATCAACTC
TGCCAGTAAGACCATAGTGACGTAGCAGTT|TCATTTCAAACGCATCAACTCATTTCTGTA
TGTACGCACAGTGTACGCACAGCATGTTCC|GGTGCGATCCCGGCGCCGCCAAACGCATCA
CCAATCAATTAGGCCGGCTAATTGTTCTCG|ATCAACTCATTTCTGTACGCACAGAGAAGG
ACATCCGGATTCCCTCAATGTCTGCTGGCC|AATCAATTAGGCCGGCTAATTGTTCTCGTG
CATACTTAACCTCGGCGAAACGCATCAACT|CATCAACTCATTTCTGTACGCACAAACGCA
TCGCCTCCGAAGACGGCTAAACGCATCAAC|GGCTCTAAACGCATCAACTCATTTCTGTAC
AGAGGGATTCCGGAGCCAATGAGGACGTGG|TCATTTCTGTACGCACAGTATGTGACCTGC
ACGCATCAACTCATTTCTGTACGCACAGAG|GGAAGCGAATGGGGGGACTGAGTTCTTTGG
ATCAACTCATTTCTGTACGCACAGGTCAAG|CGATTTGCGTTGCCACTGAACATTAACATC
CCACTGAACATTAACATCCGGATTCCCTCA|CACAGCGGAGCCCAATCAATTAGGCCGGCT
GTACGCACAAACGCATCAACTCATTTCTGT|GGAGCGACCGGGAAGCGAATGGGGGGACTG
ACGAAAAGCACACAGGAGCGACCGGGAAGC|GAGGATAGAAACGATGCGCCTAATAAAAGC
TCTGTACGCACAAACGCATCAACTCATTTC|GCCTACTGCACGTGGGTCACACCGGCAAAA
TCTCCTTGCCTGTCATAGCGCAATACTCAT|ACAGCATGTTCCAGCCGTATGGAAACGCAT
GCCTACTGCACGTGGGTCACACCGGCAAAA|GGATTCCCTCAATGTCTGCTGGCCCGGGCG
GGGGGGACTGAGTTCTTTGGGTAAAGATTT|GGTGAGTTGAATGCCGCATCAAGACCCTGC
GCACCTGTATTGCATCCCGTGGTAAACTGA|CGAAGGCCAAGTTGGTGTCGTGGTATATGG
CAGTGTACGCACAGCATGTTCCAGCCGTAT|CCCGGCGCCGCCAAACGCATCAACTCATTT
AGGTTTCAGCCCGCGCAAACGCATCAACTC|GCAATTATTTCGGTATATACGAACGAAAAG
AGTGACGTAGCAGTTTCCAAACGCATCAAC|CAACTCATTTCTGTACGCACAGAAACGCAT
AGCCCGCGCAAACGCATCAACTCATTTCTG|TTTCGGTATATACGAACGAAAAGCACACAG
AACGCATCAACTCATTTCTGTACGCACAAA|TACGCACAGGTCAAGCGCCTACTGCACGTG
AGACGGCTAAACGCATCAACTCATTTCTGT|GCATCAACTCATTTCTGTACGCACAGCAGC
CTCATTTCTGTACGCACAGGGATTGCGGAG|TCAACTCATTTCTGTACGCACAGTGTACGC
AGCATGTTCCAGCCGTATGGAAACGCATCA|AAACGCATCAACTCATTTCTGTACGCACAG
TCTGTACGCACAGAGTCCTCGCCACTTGCC|ACTTAACCTCGGCGAAACGCATCAACTCAT
TGGATTAATTCTGTGGTCCTTATCGTTTGG|CACAGAGTCCTCGCCACTTGCCAGTAAGAC
AAAGATTTCGCCATCCGCAGGACTGCGTCG|GACCCTGCACCAGGGAAGTAAGATAAAGCA
CAGCATGTTCCAGCCGTATGGAAACGCATC|CAAACGCATCAACTCATTTCTGTACGCACA
ACGCACAGAGTCCTCGCCACTTGCCAGTAA|ACCTCGGCGAAACGCATCAACTCATTTCAA
CACCGGCAAAACGCATCAACTCATTTCTGT|TGGCCCGGGCGGACATCTGACAGCCAAACG
CGAAGACGGCTAAACGCATCAACTCATTTC|AACGCATCAACTCATTTCTGTACGCACAGC
TCATTTCTGTACGCACAGGCTCGGAGCGGG|GCACAGCAGCATCCTATCCTTCATAGGGTC
GGTCCTTATCGTTTGGCTCTAAACGCATCA|CACTTGCCAGTAAGACCATAGTGACGTAGC
CTCATTTCAAACGCATCAACTCATTTCTGT|CATCAACTCATTTCTGTACGCACAGAGGGA
CTGTGGTCCTTATCGTTTGGCTCTAAACGC|TCGCCACTTGCCAGTAAGACCATAGTGACG
TAATTAATGACCTGAGGTCACGCAATTATT|TGGTGTAAATGCCTTGCACCTGTATTGCAT
TGTCATAGCGCAATACTCATACTTAACCTC|CCAGCCGTATGGAAACGCATCAACTCATTT
GGGATCCCGAGATCCCAAACACAGTTGTTA|CGCGTTAACCCAAACGCATCAACTCATTTC
TTGCCACTGAACATTAACATCCGGATTCCC|AGTCACAGCGGAGCCCAATCAATTAGGCCG
AGTCCTCGCCACTTGCCAGTAAGACCATAG|GAAACGCATCAACTCATTTCAAACGCATCA
TTAGGCCGGCTAATTGTTCTCGTGCGTCGC|ATTTCTGTACGCACAGAGAAGGATCATAAG
CATCAACTCATTTCTGTACGCACAAACGCA|CACAGGTCAAGCGCCTACTGCACGTGGGTC
AGCCCAATCAATTAGGCCGGCTAATTGTTC|CGCATCAACTCATTTCTGTACGCACAGAGA
CTGCGTCGTTGGTGTAAATGCCTTGCACCT|ATAAAGCAGACTGCTTAGAGCGTCCGAAGG
TAACCCAAACGCATCAACTCATTTCTGTAC|GCCTGTCATAGCGCAATACTCATACTTAAC
TCATTTCTGTACGCACAGAACTAATGTCCG|GTTGTTACTGAAATGGATTAATTCTGTGGT
CGCGTTAACCCAAACGCATCAACTCATTTC|TCCTTGCCTGTCATAGCGCAATACTCATAC
TTTCGCCATCCGCAGGACTGCGTCGTTGGT|TGCACCAGGGAAGTAAGATAAAGCAGACTG
GGAGTCTCCTTGCCTGTCATAGCGCAATAC|ACGCACAGCATGTTCCAGCCGTATGGAAAC
TTCGGTATATACGAACGAAAAGCACACAGG|TCCCGTGGTAAACTGAGGATAGAAACGATG
AATTAGGCCGGCTAATTGTTCTCGTGCGTC|TCATTTCTGTACGCACAGAGAAGGATCATA
CACAGAACTAATGTCCGATCACGCTTCTTC|TGGATTAATTCTGTGGTCCTTATCGTTTGG
TATGGAAACGCATCAACTCATTTCTGTACG|TTTCTGTACGCACAGGTCAAGCGCCTACTG
ATACTCATACTTAACCTCGGCGAAACGCAT|AAACGCATCAACTCATTTCTGTACGCACAA
TTGCCAGTAAGACCATAGTGACGTAGCAGT|CTCATTTCAAACGCATCAACTCATTTCTGT
CCGAGATCCCAAACACAGTTGTTACTGAAA|AACCCAAACGCATCAACTCATTTCTGTACG
TTTCTGTACGCACAGCAGCATCCTATCCTT|CCAAACGCATCAACTCATTTCTGTACGCAC
GCCCTAGTGCCGTCCGGCGCGTGACGTAGG|GTCAGGTAATTAATGACCTGAGGTCACGCA
AGGTCAAGCGCCTACTGCACGTGGGTCACA|TTAACATCCGGATTCCCTCAATGTCTGCTG
TACTCATACTTAACCTCGGCGAAACGCATC|AACGCATCAACTCATTTCTGTACGCACAAA
TCCCAAACACAGTTGTTACTGAAATGGATT|AACGCATCAACTCATTTCTGTACGCACAGA
GGGATTGCGGAGTCTCCTTGCCTGTCATAG|CACAGTGTACGCACAGCATGTTCCAGCCGT
CTGTACGCACAGAGAAGGATCATAAGTCGT|ACTGAGTTCTTTGGGTAAAGATTTCGCCAT
GCCTTGAGTCACAGCGGAGCCCAATCAATT|ATTTCTGTACGCACAAACGCATCAACTCAT
GTCCGGCGCGTGACGTAGGTTTCAGCCCGC|AATGACCTGAGGTCACGCAATTATTTCGGT
ATTTCTGTACGCACAGGGATTGCGGAGTCT|ACTCATTTCTGTACGCACAGTGTACGCACA
GCACAGAGAAGGATCATAAGTCGTACAGAC|TTCTTTGGGTAAAGATTTCGCCATCCGCAG
GGGTAAAGATTTCGCCATCCGCAGGACTGC|TCAAGACCCTGCACCAGGGAAGTAAGATAA
CTTAACCTCGGCGAAACGCATCAACTCATT|AACTCATTTCTGTACGCACAAACGCATCAA
ACGCACAGTGTACGCACAGCATGTTCCAGC|GCGATCCCGGCGCCGCCAAACGCATCAACT
CAATGGATACACCGGGGAAACTGTGGGATT|GCACAGAGGATTCTTAAAGCTACAGAGCCT
GTATGTGACCTGCAATGGATACACCGGGGA|TCATTTCTGTACGCACAGAGGATTCTTAAA
CGATCACGCTTCTTCGCCTCCGAAGACGGC|GTCCTTATCGTTTGGCTCTAAACGCATCAA
AGTTGTTACTGAAATGGATTAATTCTGTGG|CTCATTTCTGTACGCACAGAGTCCTCGCCA
TTCGCCTCCGAAGACGGCTAAACGCATCAA|TGGCTCTAAACGCATCAACTCATTTCTGTA
GCTGGCCCGGGCGGACATCTGACAGCCAAA|TCTCGTGCGTCGCGTAGCTTCATGCCCTGC
ACAGGCTCGGAGCGGGGAGCATGGGATCCC|TATCCTTCATAGGGTCCTAAATCGCGTTAA
GACCATAGTGACGTAGCAGTTTCCAAACGC|ACGCATCAACTCATTTCTGTACGCACAGAA
TCATTTCTGTACGCACAGTGTACGCACAGC|TGGCAGGGGTGCGATCCCGGCGCCGCCAAA
TTCTCGTGCGTCGCGTAGCTTCATGCCCTG|AGAAGGATCATAAGTCGTACAGACCCAGAG
GACTGAGTTCTTTGGGTAAAGATTTCGCCA|GTTGAATGCCGCATCAAGACCCTGCACCAG
CTGTACGCACAGGGATTGCGGAGTCTCCTT|ATTTCTGTACGCACAGTGTACGCACAGCAT
AGAAGGATCATAAGTCGTACAGACCCAGAG|GGGTAAAGATTTCGCCATCCGCAGGACTGC
CATAAGTCGTACAGACCCAGAGTCAGGTAA|ATTTCGCCATCCGCAGGACTGCGTCGTTGG
TCGTACAGACCCAGAGTCAGGTAATTAATG|CCATCCGCAGGACTGCGTCGTTGGTGTAAA
TGTACGCACAGAGGATTCTTAAAGCTACAG|GCGTGACGTAGGTTTCAGCCCGCGCAAACG
GACGTAGGTTTCAGCCCGCGCAAACGCATC|GTCACGCAATTATTTCGGTATATACGAACG
TGCACGTGGGTCACACCGGCAAAACGCATC|CCTCAATGTCTGCTGGCCCGGGCGGACATC
ATCAACTCATTTCTGTACGCACAGGGATTG|ACGCATCAACTCATTTCTGTACGCACAGTG
AACTCATTTCTGTACGCACAGCAGCATCCT|CAGTTTCCAAACGCATCAACTCATTTCTGT
TCTAAACGCATCAACTCATTTCTGTACGCA|ATAGTGACGTAGCAGTTTCCAAACGCATCA
TACGCACAAACGCATCAACTCATTTCTGTA|GAGCGACCGGGAAGCGAATGGGGGGACTGA
AAACGCATCAACTCATTTCTGTACGCACAG|CGGGAAGCGAATGGGGGGACTGAGTTCTTT
AGACCATAGTGACGTAGCAGTTTCCAAACG|AACGCATCAACTCATTTCTGTACGCACAGA
CTTTGGGTAAAGATTTCGCCATCCGCAGGA|CGCATCAAGACCCTGCACCAGGGAAGTAAG
ATCCGCAGGACTGCGTCGTTGGTGTAAATG|GGGAAGTAAGATAAAGCAGACTGCTTAGAG
CATCCCGTGGTAAACTGAGGATAGAAACGA|TGGTGTCGTGGTATATGGCGAGTCTTTCGT
GCGTGACGTAGGTTTCAGCCCGCGCAAACG|TGAGGTCACGCAATTATTTCGGTATATACG
TTTCTGTACGCACAGTATGTGACCTGCAAT|CCAAACGCATCAACTCATTTCTGTACGCAC
GTGCGTCGCGTAGCTTCATGCCCTGCCCTA|GATCATAAGTCGTACAGACCCAGAGTCAGG
CCTGAGGTCACGCAATTATTTCGGTATATA|GCCTTGCACCTGTATTGCATCCCGTGGTAA
CCTTCATAGGGTCCTAAATCGCGTTAACCC|GCACAGGGATTGCGGAGTCTCCTTGCCTGT
ACTGCGTCGTTGGTGTAAATGCCTTGCACC|GATAAAGCAGACTGCTTAGAGCGTCCGAAG
CAGGACTGCGTCGTTGGTGTAAATGCCTTG|GTAAGATAAAGCAGACTGCTTAGAGCGTCC
GCCCTGCCCTAGTGCCGTCCGGCGCGTGAC|CCAGAGTCAGGTAATTAATGACCTGAGGTC
ACTCATTTCTGTACGCACAGTGTACGCACA|CGTGGCAGGGGTGCGATCCCGGCGCCGCCA
TTTGCGTTGCCACTGAACATTAACATCCGG|GCCTTGAGTCACAGCGGAGCCCAATCAATT
CGCATCAACTCATTTCTGTACGCACAGGTC|TTACGATTTGCGTTGCCACTGAACATTAAC
CTCATTTCTGTACGCACAGGCTCGGAGCGG|CGCACAGCAGCATCCTATCCTTCATAGGGT
GTACGCACAGTGTACGCACAGCATGTTCCA|GTGCGATCCCGGCGCCGCCAAACGCATCAA
ACGCTTCTTCGCCTCCGAAGACGGCTAAAC|TATCGTTTGGCTCTAAACGCATCAACTCAT
GGTGTAAATGCCTTGCACCTGTATTGCATC|CTGCTTAGAGCGTCCGAAGGCCAAGTTGGT
TTGCATCCCGTGGTAAACTGAGGATAGAAA|AGTTGGTGTCGTGGTATATGGCGAGTCTTT
ACTTGCCAGTAAGACCATAGTGACGTAGCA|AACTCATTTCAAACGCATCAACTCATTTCT
TAGCGCAATACTCATACTTAACCTCGGCGA|CGTATGGAAACGCATCAACTCATTTCTGTA
ATCAACTCATTTCTGTACGCACAGAAACGC|TGTACGCACAGAGGGATTCCGGAGCCAATG
GTGGTCCTTATCGTTTGGCTCTAAACGCAT|GCCACTTGCCAGTAAGACCATAGTGACGTA
CCGCGCAAACGCATCAACTCATTTCTGTAC|CGGTATATACGAACGAAAAGCACACAGGAG
AGTCACAGCGGAGCCCAATCAATTAGGCCG|GTACGCACAAACGCATCAACTCATTTCTGT
GAAACGCATCAACTCATTTCTGTACGCACA|TGTACGCACAGGTCAAGCGCCTACTGCACG
TCAATTAGGCCGGCTAATTGTTCTCGTGCG|ACTCATTTCTGTACGCACAGAGAAGGATCA
TTTCTGTACGCACAGAAACGCATCAACTCA|AGAGGGATTCCGGAGCCAATGAGGACGTGG
GGTGCGATCCCGGCGCCGCCAAACGCATCA|GATACACCGGGGAAACTGTGGGATTACGAT
GGTCACGCAATTATTTCGGTATATACGAAC|GCACCTGTATTGCATCCCGTGGTAAACTGA
GGGGTGCGATCCCGGCGCCGCCAAACGCAT|TGGATACACCGGGGAAACTGTGGGATTACG
CGTCCGGCGCGTGACGTAGGTTTCAGCCCG|TAATGACCTGAGGTCACGCAATTATTTCGG
TATCGTTTGGCTCTAAACGCATCAACTCAT|CCAGTAAGACCATAGTGACGTAGCAGTTTC
AAGCGCCTACTGCACGTGGGTCACACCGGC|ATCCGGATTCCCTCAATGTCTGCTGGCCCG
ATTCTTAAAGCTACAGAGCCTTCTGGCCTT|TCAGCCCGCGCAAACGCATCAACTCATTTC
CCTGCAATGGATACACCGGGGAAACTGTGG|GTACGCACAGAGGATTCTTAAAGCTACAGA
TGCCTGTCATAGCGCAATACTCATACTTAA|TGTTCCAGCCGTATGGAAACGCATCAACTC
CCCAATCAATTAGGCCGGCTAATTGTTCTC|CATCAACTCATTTCTGTACGCACAGAGAAG
CATCAACTCATTTCTGTACGCACAGAGAAG|AGCGAATGGGGGGACTGAGTTCTTTGGGTA
TCCAAACGCATCAACTCATTTCTGTACGCA|CGCACAGAAACGCATCAACTCATTTCTGTA
TTCAGCCCGCGCAAACGCATCAACTCATTT|TTATTTCGGTATATACGAACGAAAAGCACA
CCCGGGCGGACATCTGACAGCCAAACGCAT|TGCGTCGCGTAGCTTCATGCCCTGCCCTAG
AGTTCTTTGGGTAAAGATTTCGCCATCCGC|ATGCCGCATCAAGACCCTGCACCAGGGAAG
TCGCCATCCGCAGGACTGCGTCGTTGGTGT|CACCAGGGAAGTAAGATAAAGCAGACTGCT
TATACGAACGAAAAGCACACAGGAGCGACC|GTAAACTGAGGATAGAAACGATGCGCCTAA
GCATCAACTCATTTCTGTACGCACAAACGC|GCACAGGTCAAGCGCCTACTGCACGTGGGT
TCCTTGCCTGTCATAGCGCAATACTCATAC|AGCATGTTCCAGCCGTATGGAAACGCATCA
CACAGCAGCATCCTATCCTTCATAGGGTCC|CAACTCATTTCTGTACGCACAGGGATTGCG
AAATGCCTTGCACCTGTATTGCATCCCGTG|TAGAGCGTCCGAAGGCCAAGTTGGTGTCGT
ATCCCGGCGCCGCCAAACGCATCAACTCAT|CCGGGGAAACTGTGGGATTACGATTTGCGT
GGCCTTGAGTCACAGCGGAGCCCAATCAAT|CATTTCTGTACGCACAAACGCATCAACTCA
CCTACTGCACGTGGGTCACACCGGCAAAAC|GATTCCCTCAATGTCTGCTGGCCCGGGCGG
GCATCAACTCATTTCTGTACGCACAGCAGC|CGTAGCAGTTTCCAAACGCATCAACTCATT
CTTCATAGGGTCCTAAATCGCGTTAACCCA|CACAGGGATTGCGGAGTCTCCTTGCCTGTC
GTTTCAGCCCGCGCAAACGCATCAACTCAT|AATTATTTCGGTATATACGAACGAAAAGCA
CGCCGCCAAACGCATCAACTCATTTCTGTA|AACTGTGGGATTACGATTTGCGTTGCCACT
AGCGCCTACTGCACGTGGGTCACACCGGCA|TCCGGATTCCCTCAATGTCTGCTGGCCCGG
GGAGCATGGGATCCCGAGATCCCAAACACA|CCTAAATCGCGTTAACCCAAACGCATCAAC
TTCTGTACGCACAGGTCAAGCGCCTACTGC|TGCCACTGAACATTAACATCCGGATTCCCT
TACAGACCCAGAGTCAGGTAATTAATGACC|TCCGCAGGACTGCGTCGTTGGTGTAAATGC
GTGCCGTCCGGCGCGTGACGTAGGTTTCAG|TAATTAATGACCTGAGGTCACGCAATTATT
CCTGCCCTAGTGCCGTCCGGCGCGTGACGT|AGAGTCAGGTAATTAATGACCTGAGGTCAC
CGTGCGTCGCGTAGCTTCATGCCCTGCCCT|GGATCATAAGTCGTACAGACCCAGAGTCAG
GTCATAGCGCAATACTCATACTTAACCTCG|CAGCCGTATGGAAACGCATCAACTCATTTC
AACGCATCAACTCATTTCTGTACGCACAGT|CAATGAGGACGTGGCAGGGGTGCGATCCCG
GATCCCGGCGCCGCCAAACGCATCAACTCA|ACCGGGGAAACTGTGGGATTACGATTTGCG
ACAGTATGTGACCTGCAATGGATACACCGG|AACTCATTTCTGTACGCACAGAGGATTCTT
AGTTTCCAAACGCATCAACTCATTTCTGTA|TGTACGCACAGAAACGCATCAACTCATTTC
TCATAGGGTCCTAAATCGCGTTAACCCAAA|CAGGGATTGCGGAGTCTCCTTGCCTGTCAT
GCATCAACTCATTTCTGTACGCACAGTATG|ACATCTGACAGCCAAACGCATCAACTCATT
CGTATGGAAACGCATCAACTCATTTCTGTA|CATTTCTGTACGCACAGGTCAAGCGCCTAC
GTCCTAAATCGCGTTAACCCAAACGCATCA|TGCGGAGTCTCCTTGCCTGTCATAGCGCAA
TTACTGAAATGGATTAATTCTGTGGTCCTT|TTCTGTACGCACAGAGTCCTCGCCACTTGC
TTGTTACTGAAATGGATTAATTCTGTGGTC|CATTTCTGTACGCACAGAGTCCTCGCCACT
GCGCAATACTCATACTTAACCTCGGCGAAA|TATGGAAACGCATCAACTCATTTCTGTACG
CTGTACGCACAGGTCAAGCGCCTACTGCAC|CCACTGAACATTAACATCCGGATTCCCTCA
GCATCAACTCATTTCTGTACGCACAGTGTA|TGAGGACGTGGCAGGGGTGCGATCCCGGCG
TAAATGCCTTGCACCTGTATTGCATCCCGT|TTAGAGCGTCCGAAGGCCAAGTTGGTGTCG
TCATTTCTGTACGCACAGAGGGATTCCGGA|GGCAAAACGCATCAACTCATTTCTGTACGC
TCCCTCAATGTCTGCTGGCCCGGGCGGACA|GCCGGCTAATTGTTCTCGTGCGTCGCGTAG
TGAGGTCACGCAATTATTTCGGTATATACG|CTTGCACCTGTATTGCATCCCGTGGTAAAC
GCCACTGAACATTAACATCCGGATTCCCTC|TCACAGCGGAGCCCAATCAATTAGGCCGGC
ACCATAGTGACGTAGCAGTTTCCAAACGCA|CGCATCAACTCATTTCTGTACGCACAGAAA
AACACAGTTGTTACTGAAATGGATTAATTC|ATCAACTCATTTCTGTACGCACAGAGTCCT
AGCATCCTATCCTTCATAGGGTCCTAAATC|ATTTCTGTACGCACAGGGATTGCGGAGTCT
GATAAACGCATCAACTCATTTCTGTACGCA|GAGATCCCAAACACAGTTGTTACTGAAATG
ACGCATCAACTCATTTCTGTACGCACAGAA|CCCAAACACAGTTGTTACTGAAATGGATTA
GCGAAACGCATCAACTCATTTCAAACGCAT|TGTACGCACAAACGCATCAACTCATTTCTG
ACATCTGACAGCCAAACGCATCAACTCATT|TAGCTTCATGCCCTGCCCTAGTGCCGTCCG
GACCGGGAAGCGAATGGGGGGACTGAGTTC|CTAATAAAAGCCATGGGTGAGTTGAATGCC
GCATCAACTCATTTCTGTACGCACAGGGAT|AAACGCATCAACTCATTTCTGTACGCACAG
CTGAAATGGATTAATTCTGTGGTCCTTATC|TGTACGCACAGAGTCCTCGCCACTTGCCAG
ATCCCGTGGTAAACTGAGGATAGAAACGAT|GGTGTCGTGGTATATGGCGAGTCTTTCGTT
CTTAAAGCTACAGAGCCTTCTGGCCTTGAG|GCCCGCGCAAACGCATCAACTCATTTCTGT
ACGCACAGAAACGCATCAACTCATTTCTGT|TTCCGGAGCCAATGAGGACGTGGCAGGGGT
TCATACTTAACCTCGGCGAAACGCATCAAC|GCATCAACTCATTTCTGTACGCACAAACGC
GATTACGATTTGCGTTGCCACTGAACATTA|GCCTTCTGGCCTTGAGTCACAGCGGAGCCC
TCGGTATATACGAACGAAAAGCACACAGGA|CCCGTGGTAAACTGAGGATAGAAACGATGC
TAACATCCGGATTCCCTCAATGTCTGCTGG|CCAATCAATTAGGCCGGCTAATTGTTCTCG
CTGTACGCACAGCAGCATCCTATCCTTCAT|AACGCATCAACTCATTTCTGTACGCACAGG
TCAACTCATTTCTGTACGCACAGAACTAAT|ACACAGTTGTTACTGAAATGGATTAATTCT
AATGACCTGAGGTCACGCAATTATTTCGGT|TAAATGCCTTGCACCTGTATTGCATCCCGT
TTGCCTGTCATAGCGCAATACTCATACTTA|ATGTTCCAGCCGTATGGAAACGCATCAACT
TCAACTCATTTCTGTACGCACAGGGATTGC|CGCATCAACTCATTTCTGTACGCACAGTGT
GCATCAACTCATTTCTGTACGCACAGAGGA|CTAGTGCCGTCCGGCGCGTGACGTAGGTTT
CTGTACGCACAGAGGATTCTTAAAGCTACA|CGCGTGACGTAGGTTTCAGCCCGCGCAAAC
TACGCACAGGTCAAGCGCCTACTGCACGTG|CTGAACATTAACATCCGGATTCCCTCAATG
ATTACGATTTGCGTTGCCACTGAACATTAA|CCTTCTGGCCTTGAGTCACAGCGGAGCCCA
TTTCTGTACGCACAAACGCATCAACTCATT|GCGCCTACTGCACGTGGGTCACACCGGCAA
CCTCAATGTCTGCTGGCCCGGGCGGACATC|CGGCTAATTGTTCTCGTGCGTCGCGTAGCT
ATCGCGTTAACCCAAACGCATCAACTCATT|TCTCCTTGCCTGTCATAGCGCAATACTCAT
ATCCTTCATAGGGTCCTAAATCGCGTTAAC|ACGCACAGGGATTGCGGAGTCTCCTTGCCT
AAACGCATCAACTCATTTCTGTACGCACAA|ATACGAACGAAAAGCACACAGGAGCGACCG
GGGTCACACCGGCAAAACGCATCAACTCAT|GTCTGCTGGCCCGGGCGGACATCTGACAGC
CCCAGAGTCAGGTAATTAATGACCTGAGGT|GGACTGCGTCGTTGGTGTAAATGCCTTGCA
CCTAGTGCCGTCCGGCGCGTGACGTAGGTT|CAGGTAATTAATGACCTGAGGTCACGCAAT
CAAACGCATCAACTCATTTCTGTACGCACA|TATACGAACGAAAAGCACACAGGAGCGACC
TCATTTCTGTACGCACAGGTCAAGCGCCTA|GCGTTGCCACTGAACATTAACATCCGGATT
GGACGTGGCAGGGGTGCGATCCCGGCGCCG|TGACCTGCAATGGATACACCGGGGAAACTG
TTCTGTACGCACAGAGAAGGATCATAAGTC|GGACTGAGTTCTTTGGGTAAAGATTTCGCC
AGTAAGACCATAGTGACGTAGCAGTTTCCA|TTCAAACGCATCAACTCATTTCTGTACGCA
CATCTGACAGCCAAACGCATCAACTCATTT|AGCTTCATGCCCTGCCCTAGTGCCGTCCGG
ACGCATCAACTCATTTCTGTACGCACAGTA|GGACATCTGACAGCCAAACGCATCAACTCA
AAGATTTCGCCATCCGCAGGACTGCGTCGT|ACCCTGCACCAGGGAAGTAAGATAAAGCAG
ATTAACATCCGGATTCCCTCAATGTCTGCT|GCCCAATCAATTAGGCCGGCTAATTGTTCT
TGGATACACCGGGGAAACTGTGGGATTACG|CAGAGGATTCTTAAAGCTACAGAGCCTTCT
CGTGGCAGGGGTGCGATCCCGGCGCCGCCA|CCTGCAATGGATACACCGGGGAAACTGTGG
TACGCACAGCATGTTCCAGCCGTATGGAAA|CGCCGCCAAACGCATCAACTCATTTCTGTA
ACGCACAAACGCATCAACTCATTTCTGTAC|CTGCACGTGGGTCACACCGGCAAAACGCAT
ACTCATTTCTGTACGCACAGGCTCGGAGCG|ACGCACAGCAGCATCCTATCCTTCATAGGG
TAAACTGAGGATAGAAACGATGCGCCTAAT|GTATATGGCGAGTCTTTCGTTCTAATAGTA
CGCCTACTGCACGTGGGTCACACCGGCAAA|CGGATTCCCTCAATGTCTGCTGGCCCGGGC
TTTCAAACGCATCAACTCATTTCTGTACGC|AACTCATTTCTGTACGCACAGAGGGATTCC
CTGTACGCACAAACGCATCAACTCATTTCT|CAGGAGCGACCGGGAAGCGAATGGGGGGAC
GGAGCGGGGAGCATGGGATCCCGAGATCCC|ATAGGGTCCTAAATCGCGTTAACCCAAACG
CGGGGAGCATGGGATCCCGAGATCCCAAAC|GGTCCTAAATCGCGTTAACCCAAACGCATC
ATGGATTAATTCTGTGGTCCTTATCGTTTG|GCACAGAGTCCTCGCCACTTGCCAGTAAGA
TCCGGCGCGTGACGTAGGTTTCAGCCCGCG|ATGACCTGAGGTCACGCAATTATTTCGGTA
TTTCTGTACGCACAGAGAAGGATCATAAGT|GGGACTGAGTTCTTTGGGTAAAGATTTCGC
CTGCAATGGATACACCGGGGAAACTGTGGG|TACGCACAGAGGATTCTTAAAGCTACAGAG
GCAATTATTTCGGTATATACGAACGAAAAG|GTATTGCATCCCGTGGTAAACTGAGGATAG
ACAGAGGATTCTTAAAGCTACAGAGCCTTC|GTAGGTTTCAGCCCGCGCAAACGCATCAAC
CAATGTCTGCTGGCCCGGGCGGACATCTGA|CTAATTGTTCTCGTGCGTCGCGTAGCTTCA
CGCATCAACTCATTTCTGTACGCACAAACG|CGAACGAAAAGCACACAGGAGCGACCGGGA
ACGCACAGTATGTGACCTGCAATGGATACA|CATCAACTCATTTCTGTACGCACAGAGGAT
TGGTAAACTGAGGATAGAAACGATGCGCCT|GTGGTATATGGCGAGTCTTTCGTTCTAATA
TGTAAATGCCTTGCACCTGTATTGCATCCC|GCTTAGAGCGTCCGAAGGCCAAGTTGGTGT
GCGTCGCGTAGCTTCATGCCCTGCCCTAGT|TCATAAGTCGTACAGACCCAGAGTCAGGTA
TAAAGATTTCGCCATCCGCAGGACTGCGTC|AGACCCTGCACCAGGGAAGTAAGATAAAGC
AACTCATTTCTGTACGCACAGTATGTGACC|TGACAGCCAAACGCATCAACTCATTTCTGT
GGAGCGACCGGGAAGCGAATGGGGGGACTG|TGCGCCTAATAAAAGCCATGGGTGAGTTGA
TCACGCTTCTTCGCCTCCGAAGACGGCTAA|CTTATCGTTTGGCTCTAAACGCATCAACTC
GCTACAGAGCCTTCTGGCCTTGAGTCACAG|GCAAACGCATCAACTCATTTCTGTACGCAC
TATGTGACCTGCAATGGATACACCGGGGAA|CATTTCTGTACGCACAGAGGATTCTTAAAG
TCGCGTTAACCCAAACGCATCAACTCATTT|CTCCTTGCCTGTCATAGCGCAATACTCATA
GCCAAACGCATCAACTCATTTCTGTACGCA|CCCTGCCCTAGTGCCGTCCGGCGCGTGACG
ACCGGGAAGCGAATGGGGGGACTGAGTTCT|TAATAAAAGCCATGGGTGAGTTGAATGCCG
TTTGGCTCTAAACGCATCAACTCATTTCTG|AAGACCATAGTGACGTAGCAGTTTCCAAAC
TGCGTTGCCACTGAACATTAACATCCGGAT|CTTGAGTCACAGCGGAGCCCAATCAATTAG
TACGCACAGCAGCATCCTATCCTTCATAGG|GCATCAACTCATTTCTGTACGCACAGGGAT
AGCATGGGATCCCGAGATCCCAAACACAGT|TAAATCGCGTTAACCCAAACGCATCAACTC
CGTACAGACCCAGAGTCAGGTAATTAATGA|CATCCGCAGGACTGCGTCGTTGGTGTAAAT
TAGGCCGGCTAATTGTTCTCGTGCGTCGCG|TTTCTGTACGCACAGAGAAGGATCATAAGT
AAACGCATCAACTCATTTCTGTACGCACAG|GGATTACGATTTGCGTTGCCACTGAACATT
TCATTTCAAACGCATCAACTCATTTCTGTA|ATCAACTCATTTCTGTACGCACAGAGGGAT
TAAACGCATCAACTCATTTCTGTACGCACA|AGTGACGTAGCAGTTTCCAAACGCATCAAC
TCATAAGTCGTACAGACCCAGAGTCAGGTA|GATTTCGCCATCCGCAGGACTGCGTCGTTG
GGATTCTTAAAGCTACAGAGCCTTCTGGCC|TTTCAGCCCGCGCAAACGCATCAACTCATT
CACAAACGCATCAACTCATTTCTGTACGCA|CACGTGGGTCACACCGGCAAAACGCATCAA
CCTCGCCACTTGCCAGTAAGACCATAGTGA|ACGCATCAACTCATTTCAAACGCATCAACT
GAGCGACCGGGAAGCGAATGGGGGGACTGA|GCGCCTAATAAAAGCCATGGGTGAGTTGAA
ATGTGACCTGCAATGGATACACCGGGGAAA|ATTTCTGTACGCACAGAGGATTCTTAAAGC
GTGTAAATGCCTTGCACCTGTATTGCATCC|TGCTTAGAGCGTCCGAAGGCCAAGTTGGTG
ATCAACTCATTTCTGTACGCACAGTATGTG|ATCTGACAGCCAAACGCATCAACTCATTTC
TGAACATTAACATCCGGATTCCCTCAATGT|GCGGAGCCCAATCAATTAGGCCGGCTAATT
CTAAACGCATCAACTCATTTCTGTACGCAC|ACTCATTTCTGTACGCACAGCAGCATCCTA
CTCCGAAGACGGCTAAACGCATCAACTCAT|CTAAACGCATCAACTCATTTCTGTACGCAC
CTGTACGCACAGAACTAATGTCCGATCACG|ACTGAAATGGATTAATTCTGTGGTCCTTAT
GCATCAACTCATTTCTGTACGCACAGAGTC|GCGCAATACTCATACTTAACCTCGGCGAAA
GTGACGTAGGTTTCAGCCCGCGCAAACGCA|AGGTCACGCAATTATTTCGGTATATACGAA
AGAGTCAGGTAATTAATGACCTGAGGTCAC|CTGCGTCGTTGGTGTAAATGCCTTGCACCT
CAATTAGGCCGGCTAATTGTTCTCGTGCGT|CTCATTTCTGTACGCACAGAGAAGGATCAT
TTTCTGTACGCACAAACGCATCAACTCATT|ACACAGGAGCGACCGGGAAGCGAATGGGGG
TGCTGGCCCGGGCGGACATCTGACAGCCAA|TTCTCGTGCGTCGCGTAGCTTCATGCCCTG
AACTCATTTCTGTACGCACAGTGTACGCAC|ACGTGGCAGGGGTGCGATCCCGGCGCCGCC
ACTCATTTCTGTACGCACAGAGGGATTCCG|CCGGCAAAACGCATCAACTCATTTCTGTAC
AGCCGTATGGAAACGCATCAACTCATTTCT|ACTCATTTCTGTACGCACAGGTCAAGCGCC
CTGAACATTAACATCCGGATTCCCTCAATG|AGCGGAGCCCAATCAATTAGGCCGGCTAAT
CCGTATGGAAACGCATCAACTCATTTCTGT|TCATTTCTGTACGCACAGGTCAAGCGCCTA
AACGCATCAACTCATTTCTGTACGCACAGA|ATAGCGCAATACTCATACTTAACCTCGGCG
TCTGTACGCACAAACGCATCAACTCATTTC|ACAGGAGCGACCGGGAAGCGAATGGGGGGA
TTTGGGTAAAGATTTCGCCATCCGCAGGAC|GCATCAAGACCCTGCACCAGGGAAGTAAGA
ACCTGAGGTCACGCAATTATTTCGGTATAT|TGCCTTGCACCTGTATTGCATCCCGTGGTA
CACAGCGGAGCCCAATCAATTAGGCCGGCT|CGCACAAACGCATCAACTCATTTCTGTACG
GTTGCCACTGAACATTAACATCCGGATTCC|GAGTCACAGCGGAGCCCAATCAATTAGGCC
CCTCGGCGAAACGCATCAACTCATTTCAAA|ATTTCTGTACGCACAAACGCATCAACTCAT
ACAGTGTACGCACAGCATGTTCCAGCCGTA|TCCCGGCGCCGCCAAACGCATCAACTCATT
ACGCATCAACTCATTTCTGTACGCACAGGC|ATTTCTGTACGCACAGCAGCATCCTATCCT
TCTTAAAGCTACAGAGCCTTCTGGCCTTGA|AGCCCGCGCAAACGCATCAACTCATTTCTG
TACGAACGAAAAGCACACAGGAGCGACCGG|AAACTGAGGATAGAAACGATGCGCCTAATA
CATCAACTCATTTCTGTACGCACAGAGTCC|CGCAATACTCATACTTAACCTCGGCGAAAC
TTCTGTACGCACAGCAGCATCCTATCCTTC|CAAACGCATCAACTCATTTCTGTACGCACA
AACGCATCAACTCATTTCTGTACGCACAGC|TGACGTAGCAGTTTCCAAACGCATCAACTC
TAATTGTTCTCGTGCGTCGCGTAGCTTCAT|GCACAGAGAAGGATCATAAGTCGTACAGAC
GCACAAACGCATCAACTCATTTCTGTACGC|CGACCGGGAAGCGAATGGGGGGACTGAGTT
CCTATCCTTCATAGGGTCCTAAATCGCGTT|TGTACGCACAGGGATTGCGGAGTCTCCTTG
CATCAACTCATTTCTGTACGCACAGAGGAT|TAGTGCCGTCCGGCGCGTGACGTAGGTTTC
ACCTCGGCGAAACGCATCAACTCATTTCAA|CATTTCTGTACGCACAAACGCATCAACTCA
ATTTCTGTACGCACAAACGCATCAACTCAT|CACACAGGAGCGACCGGGAAGCGAATGGGG
CCAAACGCATCAACTCATTTCTGTACGCAC|GCACAGAAACGCATCAACTCATTTCTGTAC
CAACTCATTTCTGTACGCACAAACGCATCA|GAAAAGCACACAGGAGCGACCGGGAAGCGA
CAGCCAAACGCATCAACTCATTTCTGTACG|TGCCCTGCCCTAGTGCCGTCCGGCGCGTGA
AATGGATTAATTCTGTGGTCCTTATCGTTT|CGCACAGAGTCCTCGCCACTTGCCAGTAAG
TGTACGCACAGAAACGCATCAACTCATTTC|GGATTCCGGAGCCAATGAGGACGTGGCAGG
GTACGCACAGAGTCCTCGCCACTTGCCAGT|TAACCTCGGCGAAACGCATCAACTCATTTC
GAACTAATGTCCGATCACGCTTCTTCGCCT|TTAATTCTGTGGTCCTTATCGTTTGGCTCT
CACAGCATGTTCCAGCCGTATGGAAACGCA|GCCAAACGCATCAACTCATTTCTGTACGCA
TACGCACAGTGTACGCACAGCATGTTCCAG|TGCGATCCCGGCGCCGCCAAACGCATCAAC
AATTAATGACCTGAGGTCACGCAATTATTT|GGTGTAAATGCCTTGCACCTGTATTGCATC
CAACTCATTTCTGTACGCACAGGTCAAGCG|ATTTGCGTTGCCACTGAACATTAACATCCG
TTGGTGTAAATGCCTTGCACCTGTATTGCA|GACTGCTTAGAGCGTCCGAAGGCCAAGTTG
TCCTTATCGTTTGGCTCTAAACGCATCAAC|CTTGCCAGTAAGACCATAGTGACGTAGCAG
AAACGCATCAACTCATTTCTGTACGCACAG|CCAATGAGGACGTGGCAGGGGTGCGATCCC
ACAAACGCATCAACTCATTTCTGTACGCAC|ACCGGGAAGCGAATGGGGGGACTGAGTTCT
CTGCACGTGGGTCACACCGGCAAAACGCAT|CCCTCAATGTCTGCTGGCCCGGGCGGACAT
GGTATATACGAACGAAAAGCACACAGGAGC|CGTGGTAAACTGAGGATAGAAACGATGCGC
AGATCCCAAACACAGTTGTTACTGAAATGG|CCAAACGCATCAACTCATTTCTGTACGCAC
CAGAGTCAGGTAATTAATGACCTGAGGTCA|ACTGCGTCGTTGGTGTAAATGCCTTGCACC
CTTCATGCCCTGCCCTAGTGCCGTCCGGCG|ACAGACCCAGAGTCAGGTAATTAATGACCT
TCAACTCATTTCTGTACGCACAGGTCAAGC|GATTTGCGTTGCCACTGAACATTAACATCC
CGCACAAACGCATCAACTCATTTCTGTACG|TGCACGTGGGTCACACCGGCAAAACGCATC
CGCATCAACTCATTTCTGTACGCACAGAGT|AGCGCAATACTCATACTTAACCTCGGCGAA
GTCGCGTAGCTTCATGCCCTGCCCTAGTGC|ATAAGTCGTACAGACCCAGAGTCAGGTAAT
CGCAATTATTTCGGTATATACGAACGAAAA|TGTATTGCATCCCGTGGTAAACTGAGGATA
AGGCTCGGAGCGGGGAGCATGGGATCCCGA|TCCTTCATAGGGTCCTAAATCGCGTTAACC
ATGGATACACCGGGGAAACTGTGGGATTAC|ACAGAGGATTCTTAAAGCTACAGAGCCTTC
ATTTCGGTATATACGAACGAAAAGCACACA|CATCCCGTGGTAAACTGAGGATAGAAACGA
AATGCCTTGCACCTGTATTGCATCCCGTGG|AGAGCGTCCGAAGGCCAAGTTGGTGTCGTG
ACGCACAGCATGTTCCAGCCGTATGGAAAC|GCCGCCAAACGCATCAACTCATTTCTGTAC
GCATCAACTCATTTCTGTACGCACAGAAAC|TCTGTACGCACAGAGGGATTCCGGAGCCAA
CTTCTGGCCTTGAGTCACAGCGGAGCCCAA|CAACTCATTTCTGTACGCACAAACGCATCA
CGATCCCGGCGCCGCCAAACGCATCAACTC|CACCGGGGAAACTGTGGGATTACGATTTGC
GCAGGGGTGCGATCCCGGCGCCGCCAAACG|CAATGGATACACCGGGGAAACTGTGGGATT
GGATTAATTCTGTGGTCCTTATCGTTTGGC|ACAGAGTCCTCGCCACTTGCCAGTAAGACC
AACGCATCAACTCATTTCTGTACGCACAGA|ATTTCTGTACGCACAGAGGGATTCCGGAGC
GTTAACCCAAACGCATCAACTCATTTCTGT|TTGCCTGTCATAGCGCAATACTCATACTTA
TAAGTCGTACAGACCCAGAGTCAGGTAATT|TTCGCCATCCGCAGGACTGCGTCGTTGGTG
CATAGTGACGTAGCAGTTTCCAAACGCATC|CATCAACTCATTTCTGTACGCACAGAAACG
AACTGTGGGATTACGATTTGCGTTGCCACT|GCTACAGAGCCTTCTGGCCTTGAGTCACAG
ATTTGCGTTGCCACTGAACATTAACATCCG|GGCCTTGAGTCACAGCGGAGCCCAATCAAT
CGCAGGACTGCGTCGTTGGTGTAAATGCCT|AAGTAAGATAAAGCAGACTGCTTAGAGCGT
TGCGTCGTTGGTGTAAATGCCTTGCACCTG|TAAAGCAGACTGCTTAGAGCGTCCGAAGGC
TGACCTGCAATGGATACACCGGGGAAACTG|TCTGTACGCACAGAGGATTCTTAAAGCTAC
ATCATAAGTCGTACAGACCCAGAGTCAGGT|AGATTTCGCCATCCGCAGGACTGCGTCGTT
CCGTGGTAAACTGAGGATAGAAACGATGCG|GTCGTGGTATATGGCGAGTCTTTCGTTCTA
CATGGGATCCCGAGATCCCAAACACAGTTG|AATCGCGTTAACCCAAACGCATCAACTCAT
CAAACGCATCAACTCATTTCTGTACGCACA|CTGCCCTAGTGCCGTCCGGCGCGTGACGTA
GCATCAACTCATTTCAAACGCATCAACTCA|ACAAACGCATCAACTCATTTCTGTACGCAC
AACTCATTTCTGTACGCACAGAGTCCTCGC|ATACTCATACTTAACCTCGGCGAAACGCAT
GGCTCGGAGCGGGGAGCATGGGATCCCGAG|CCTTCATAGGGTCCTAAATCGCGTTAACCC
CGCCTCCGAAGACGGCTAAACGCATCAACT|GCTCTAAACGCATCAACTCATTTCTGTACG
ACGCACAGAACTAATGTCCGATCACGCTTC|AAATGGATTAATTCTGTGGTCCTTATCGTT
AATTATTTCGGTATATACGAACGAAAAGCA|ATTGCATCCCGTGGTAAACTGAGGATAGAA
TGCCGTCCGGCGCGTGACGTAGGTTTCAGC|AATTAATGACCTGAGGTCACGCAATTATTT
TCATTTCTGTACGCACAGAGTCCTCGCCAC|CTCATACTTAACCTCGGCGAAACGCATCAA
TCAAGCGCCTACTGCACGTGGGTCACACCG|ACATCCGGATTCCCTCAATGTCTGCTGGCC
TCACGCAATTATTTCGGTATATACGAACGA|ACCTGTATTGCATCCCGTGGTAAACTGAGG
TGGGTCACACCGGCAAAACGCATCAACTCA|TGTCTGCTGGCCCGGGCGGACATCTGACAG
CAATACTCATACTTAACCTCGGCGAAACGC|GGAAACGCATCAACTCATTTCTGTACGCAC
GTCCTCGCCACTTGCCAGTAAGACCATAGT|AAACGCATCAACTCATTTCAAACGCATCAA
TGTGACCTGCAATGGATACACCGGGGAAAC|TTTCTGTACGCACAGAGGATTCTTAAAGCT
TGCCTTGCACCTGTATTGCATCCCGTGGTA|AGCGTCCGAAGGCCAAGTTGGTGTCGTGGT
CACACAGGAGCGACCGGGAAGCGAATGGGG|AAACGATGCGCCTAATAAAAGCCATGGGTG
GATTTGCGTTGCCACTGAACATTAACATCC|TGGCCTTGAGTCACAGCGGAGCCCAATCAA
ACGCACAGGTCAAGCGCCTACTGCACGTGG|TGAACATTAACATCCGGATTCCCTCAATGT
CAGCGGAGCCCAATCAATTAGGCCGGCTAA|CACAAACGCATCAACTCATTTCTGTACGCA
CATCAACTCATTTCTGTACGCACAGGCTCG|TCTGTACGCACAGCAGCATCCTATCCTTCA
ACTCATTTCTGTACGCACAGAGTCCTCGCC|TACTCATACTTAACCTCGGCGAAACGCATC
TACGCACAAACGCATCAACTCATTTCTGTA|ACTGCACGTGGGTCACACCGGCAAAACGCA
TCCTCGCCACTTGCCAGTAAGACCATAGTG|AACGCATCAACTCATTTCAAACGCATCAAC
CAAGCGCCTACTGCACGTGGGTCACACCGG|CATCCGGATTCCCTCAATGTCTGCTGGCCC
CATTTCTGTACGCACAGAGTCCTCGCCACT|TCATACTTAACCTCGGCGAAACGCATCAAC
ATCCTATCCTTCATAGGGTCCTAAATCGCG|TCTGTACGCACAGGGATTGCGGAGTCTCCT
CGCAATACTCATACTTAACCTCGGCGAAAC|ATGGAAACGCATCAACTCATTTCTGTACGC
CGCATCAACTCATTTCTGTACGCACAGGCT|TTTCTGTACGCACAGCAGCATCCTATCCTT
GCCTTCTGGCCTTGAGTCACAGCGGAGCCC|ATCAACTCATTTCTGTACGCACAAACGCAT
CTAATTGTTCTCGTGCGTCGCGTAGCTTCA|CGCACAGAGAAGGATCATAAGTCGTACAGA
CGCATCAACTCATTTCTGTACGCACAGTGT|ATGAGGACGTGGCAGGGGTGCGATCCCGGC
TTCTGTACGCACAAACGCATCAACTCATTT|CGCCTACTGCACGTGGGTCACACCGGCAAA
GATTTCGCCATCCGCAGGACTGCGTCGTTG|CCTGCACCAGGGAAGTAAGATAAAGCAGAC
TCATTTCTGTACGCACAGCAGCATCCTATC|TTTCCAAACGCATCAACTCATTTCTGTACG
CGCTTCTTCGCCTCCGAAGACGGCTAAACG|ATCGTTTGGCTCTAAACGCATCAACTCATT
CCTTGCACCTGTATTGCATCCCGTGGTAAA|CGTCCGAAGGCCAAGTTGGTGTCGTGGTAT
CTTGCCTGTCATAGCGCAATACTCATACTT|CATGTTCCAGCCGTATGGAAACGCATCAAC
TTGAGTCACAGCGGAGCCCAATCAATTAGG|TCTGTACGCACAAACGCATCAACTCATTTC
TTTCTGTACGCACAGGGATTGCGGAGTCTC|CTCATTTCTGTACGCACAGTGTACGCACAG
TCTGCTGGCCCGGGCGGACATCTGACAGCC|TGTTCTCGTGCGTCGCGTAGCTTCATGCCC
TCGCCACTTGCCAGTAAGACCATAGTGACG|GCATCAACTCATTTCAAACGCATCAACTCA
TCCGCAGGACTGCGTCGTTGGTGTAAATGC|GGAAGTAAGATAAAGCAGACTGCTTAGAGC
GACTGCGTCGTTGGTGTAAATGCCTTGCAC|AGATAAAGCAGACTGCTTAGAGCGTCCGAA
AAGACCATAGTGACGTAGCAGTTTCCAAAC|AAACGCATCAACTCATTTCTGTACGCACAG
GGGAAACTGTGGGATTACGATTTGCGTTGC|TAAAGCTACAGAGCCTTCTGGCCTTGAGTC
CGTCGCGTAGCTTCATGCCCTGCCCTAGTG|CATAAGTCGTACAGACCCAGAGTCAGGTAA
GTACGCACAGCAGCATCCTATCCTTCATAG|CGCATCAACTCATTTCTGTACGCACAGGGA
GCACAGTATGTGACCTGCAATGGATACACC|TCAACTCATTTCTGTACGCACAGAGGATTC
CAGCCGTATGGAAACGCATCAACTCATTTC|AACTCATTTCTGTACGCACAGGTCAAGCGC
GGAGCCAATGAGGACGTGGCAGGGGTGCGA|CGCACAGTATGTGACCTGCAATGGATACAC
TTCATGCCCTGCCCTAGTGCCGTCCGGCGC|CAGACCCAGAGTCAGGTAATTAATGACCTG
GAGTTCTTTGGGTAAAGATTTCGCCATCCG|AATGCCGCATCAAGACCCTGCACCAGGGAA
AACTCATTTCTGTACGCACAAACGCATCAA|AAAAGCACACAGGAGCGACCGGGAAGCGAA
GTACGCACAGCATGTTCCAGCCGTATGGAA|GCGCCGCCAAACGCATCAACTCATTTCTGT
CGCATCAACTCATTTCAAACGCATCAACTC|CACAAACGCATCAACTCATTTCTGTACGCA
CCTTATCGTTTGGCTCTAAACGCATCAACT|TTGCCAGTAAGACCATAGTGACGTAGCAGT
GAAACTGTGGGATTACGATTTGCGTTGCCA|AAGCTACAGAGCCTTCTGGCCTTGAGTCAC
TCCCGTGGTAAACTGAGGATAGAAACGATG|GTGTCGTGGTATATGGCGAGTCTTTCGTTC
CACAGGGATTGCGGAGTCTCCTTGCCTGTC|TACGCACAGTGTACGCACAGCATGTTCCAG
ATGACCTGAGGTCACGCAATTATTTCGGTA|AAATGCCTTGCACCTGTATTGCATCCCGTG
CGCATCAACTCATTTCTGTACGCACAGAGG|GGTCACACCGGCAAAACGCATCAACTCATT
GTACGCACAAACGCATCAACTCATTTCTGT|TACTGCACGTGGGTCACACCGGCAAAACGC
GCAAAACGCATCAACTCATTTCTGTACGCA|CGGGCGGACATCTGACAGCCAAACGCATCA
GCACAGGTCAAGCGCCTACTGCACGTGGGT|AACATTAACATCCGGATTCCCTCAATGTCT
CCCAAACACAGTTGTTACTGAAATGGATTA|ACGCATCAACTCATTTCTGTACGCACAGAG
CATTTCTGTACGCACAGAGGGATTCCGGAG|GCAAAACGCATCAACTCATTTCTGTACGCA
TCAAACGCATCAACTCATTTCTGTACGCAC|CTCATTTCTGTACGCACAGAGGGATTCCGG
TTCTGTACGCACAGAGGGATTCCGGAGCCA|AAACGCATCAACTCATTTCTGTACGCACAG
TCCGGAGCCAATGAGGACGTGGCAGGGGTG|GTACGCACAGTATGTGACCTGCAATGGATA
GGTAAAGATTTCGCCATCCGCAGGACTGCG|CAAGACCCTGCACCAGGGAAGTAAGATAAA
GTCTCCTTGCCTGTCATAGCGCAATACTCA|CACAGCATGTTCCAGCCGTATGGAAACGCA
ATGCCCTGCCCTAGTGCCGTCCGGCGCGTG|ACCCAGAGTCAGGTAATTAATGACCTGAGG
TTCAAACGCATCAACTCATTTCTGTACGCA|ACTCATTTCTGTACGCACAGAGGGATTCCG
TCCTAAATCGCGTTAACCCAAACGCATCAA|GCGGAGTCTCCTTGCCTGTCATAGCGCAAT
GTTGTTACTGAAATGGATTAATTCTGTGGT|TCATTTCTGTACGCACAGAGTCCTCGCCAC
CGCATCAACTCATTTCTGTACGCACAGTAT|GACATCTGACAGCCAAACGCATCAACTCAT
CTGTACGCACAGAGGGATTCCGGAGCCAAT|ACGCATCAACTCATTTCTGTACGCACAGTA
GTACGCACAGAGGATTCTTAAAGCTACAGA|CGTGACGTAGGTTTCAGCCCGCGCAAACGC
TTCTGTACGCACAGAGTCCTCGCCACTTGC|TACTTAACCTCGGCGAAACGCATCAACTCA
CTCATTTCTGTACGCACAGAGGATTCTTAA|CGTCCGGCGCGTGACGTAGGTTTCAGCCCG
GTGTACGCACAGCATGTTCCAGCCGTATGG|CGGCGCCGCCAAACGCATCAACTCATTTCT
GCGAATGGGGGGACTGAGTTCTTTGGGTAA|GCCATGGGTGAGTTGAATGCCGCATCAAGA
TGTACGCACAGCATGTTCCAGCCGTATGGA|GGCGCCGCCAAACGCATCAACTCATTTCTG
CTAAACGCATCAACTCATTTCTGTACGCAC|TAGTGACGTAGCAGTTTCCAAACGCATCAA
GCGCGTGACGTAGGTTTCAGCCCGCGCAAA|CCTGAGGTCACGCAATTATTTCGGTATATA
AAACGCATCAACTCATTTCTGTACGCACAG|GTGGGTCACACCGGCAAAACGCATCAACTC
GATACACCGGGGAAACTGTGGGATTACGAT|GAGGATTCTTAAAGCTACAGAGCCTTCTGG
CCATCCGCAGGACTGCGTCGTTGGTGTAAA|CAGGGAAGTAAGATAAAGCAGACTGCTTAG
AAACGCATCAACTCATTTCTGTACGCACAG|CATTTCTGTACGCACAGAGGGATTCCGGAG
CACAGAGGATTCTTAAAGCTACAGAGCCTT|CGTAGGTTTCAGCCCGCGCAAACGCATCAA
AAACGCATCAACTCATTTCTGTACGCACAG|CATAGCGCAATACTCATACTTAACCTCGGC
ATACGAACGAAAAGCACACAGGAGCGACCG|TAAACTGAGGATAGAAACGATGCGCCTAAT
TGAAATGGATTAATTCTGTGGTCCTTATCG|GTACGCACAGAGTCCTCGCCACTTGCCAGT
TCCCGGCGCCGCCAAACGCATCAACTCATT|CGGGGAAACTGTGGGATTACGATTTGCGTT
TGTACGCACAGGTCAAGCGCCTACTGCACG|CACTGAACATTAACATCCGGATTCCCTCAA
AACTCATTTCTGTACGCACAGGCTCGGAGC|TACGCACAGCAGCATCCTATCCTTCATAGG
CTCAATGTCTGCTGGCCCGGGCGGACATCT|GGCTAATTGTTCTCGTGCGTCGCGTAGCTT
ACGCACAGGGATTGCGGAGTCTCCTTGCCT|CTGTACGCACAGTGTACGCACAGCATGTTC
TCATGCCCTGCCCTAGTGCCGTCCGGCGCG|AGACCCAGAGTCAGGTAATTAATGACCTGA
TACAGAGCCTTCTGGCCTTGAGTCACAGCG|AAACGCATCAACTCATTTCTGTACGCACAA
TGGGATTACGATTTGCGTTGCCACTGAACA|AGAGCCTTCTGGCCTTGAGTCACAGCGGAG
TCGTTGGTGTAAATGCCTTGCACCTGTATT|GCAGACTGCTTAGAGCGTCCGAAGGCCAAG
AATCGCGTTAACCCAAACGCATCAACTCAT|GTCTCCTTGCCTGTCATAGCGCAATACTCA
CCGGCGCCGCCAAACGCATCAACTCATTTC|GGGAAACTGTGGGATTACGATTTGCGTTGC
TACTGCACGTGGGTCACACCGGCAAAACGC|TTCCCTCAATGTCTGCTGGCCCGGGCGGAC
TTCCCTCAATGTCTGCTGGCCCGGGCGGAC|GGCCGGCTAATTGTTCTCGTGCGTCGCGTA
CTCATTTCTGTACGCACAGGTCAAGCGCCT|TGCGTTGCCACTGAACATTAACATCCGGAT
TCTGACAGCCAAACGCATCAACTCATTTCT|CTTCATGCCCTGCCCTAGTGCCGTCCGGCG
ACTCATTTCTGTACGCACAGAGAAGGATCA|ATGGGGGGACTGAGTTCTTTGGGTAAAGAT
GAGCCCAATCAATTAGGCCGGCTAATTGTT|ACGCATCAACTCATTTCTGTACGCACAGAG
AATGAGGACGTGGCAGGGGTGCGATCCCGG|GTATGTGACCTGCAATGGATACACCGGGGA
TCACAGCGGAGCCCAATCAATTAGGCCGGC|ACGCACAAACGCATCAACTCATTTCTGTAC
ACGTGGCAGGGGTGCGATCCCGGCGCCGCC|ACCTGCAATGGATACACCGGGGAAACTGTG
GTTTGGCTCTAAACGCATCAACTCATTTCT|TAAGACCATAGTGACGTAGCAGTTTCCAAA
CTTCTTCGCCTCCGAAGACGGCTAAACGCA|CGTTTGGCTCTAAACGCATCAACTCATTTC
GTTGGTGTAAATGCCTTGCACCTGTATTGC|AGACTGCTTAGAGCGTCCGAAGGCCAAGTT
GACGTGGCAGGGGTGCGATCCCGGCGCCGC|GACCTGCAATGGATACACCGGGGAAACTGT
AGGGTCCTAAATCGCGTTAACCCAAACGCA|GATTGCGGAGTCTCCTTGCCTGTCATAGCG
ATTTCTGTACGCACAGTGTACGCACAGCAT|GCAGGGGTGCGATCCCGGCGCCGCCAAACG
TCAACTCATTTCTGTACGCACAGTATGTGA|TCTGACAGCCAAACGCATCAACTCATTTCT
CCAGTAAGACCATAGTGACGTAGCAGTTTC|ATTTCAAACGCATCAACTCATTTCTGTACG
TGCCCTAGTGCCGTCCGGCGCGTGACGTAG|AGTCAGGTAATTAATGACCTGAGGTCACGC
TCACACCGGCAAAACGCATCAACTCATTTC|TGCTGGCCCGGGCGGACATCTGACAGCCAA
AGGCCGGCTAATTGTTCTCGTGCGTCGCGT|TTCTGTACGCACAGAGAAGGATCATAAGTC
TCATTTCTGTACGCACAGTATGTGACCTGC|CAGCCAAACGCATCAACTCATTTCTGTACG
ATCAACTCATTTCTGTACGCACAAACGCAT|ACGAAAAGCACACAGGAGCGACCGGGAAGC
TATTGCATCCCGTGGTAAACTGAGGATAGA|CAAGTTGGTGTCGTGGTATATGGCGAGTCT
CGAAAAGCACACAGGAGCGACCGGGAAGCG|AGGATAGAAACGATGCGCCTAATAAAAGCC
TTCCGGAGCCAATGAGGACGTGGCAGGGGT|TGTACGCACAGTATGTGACCTGCAATGGAT
TTACGATTTGCGTTGCCACTGAACATTAAC|CTTCTGGCCTTGAGTCACAGCGGAGCCCAA
CTGTGGGATTACGATTTGCGTTGCCACTGA|TACAGAGCCTTCTGGCCTTGAGTCACAGCG
GTAAAGATTTCGCCATCCGCAGGACTGCGT|AAGACCCTGCACCAGGGAAGTAAGATAAAG
TAGTGCCGTCCGGCGCGTGACGTAGGTTTC|GGTAATTAATGACCTGAGGTCACGCAATTA
ACTCATTTCTGTACGCACAAACGCATCAAC|AAAGCACACAGGAGCGACCGGGAAGCGAAT
AGTCGTACAGACCCAGAGTCAGGTAATTAA|CGCCATCCGCAGGACTGCGTCGTTGGTGTA
TCTGTACGCACAGAGAAGGATCATAAGTCG|GACTGAGTTCTTTGGGTAAAGATTTCGCCA
ACAGCCAAACGCATCAACTCATTTCTGTAC|ATGCCCTGCCCTAGTGCCGTCCGGCGCGTG
GTAGGTTTCAGCCCGCGCAAACGCATCAAC|ACGCAATTATTTCGGTATATACGAACGAAA
GCATCAACTCATTTCTGTACGCACAGGCTC|TTCTGTACGCACAGCAGCATCCTATCCTTC
ATTAATTCTGTGGTCCTTATCGTTTGGCTC|AGAGTCCTCGCCACTTGCCAGTAAGACCAT
TCAACTCATTTCTGTACGCACAGGCTCGGA|TGTACGCACAGCAGCATCCTATCCTTCATA
GGGGAGCATGGGATCCCGAGATCCCAAACA|GTCCTAAATCGCGTTAACCCAAACGCATCA
TAATTCTGTGGTCCTTATCGTTTGGCTCTA|AGTCCTCGCCACTTGCCAGTAAGACCATAG
AACGCATCAACTCATTTCTGTACGCACAGA|GGGAAGCGAATGGGGGGACTGAGTTCTTTG
CTGTACGCACAGAAACGCATCAACTCATTT|GGGATTCCGGAGCCAATGAGGACGTGGCAG
ATGAGGACGTGGCAGGGGTGCGATCCCGGC|TATGTGACCTGCAATGGATACACCGGGGAA
GCCGTATGGAAACGCATCAACTCATTTCTG|CTCATTTCTGTACGCACAGGTCAAGCGCCT
TGGTCCTTATCGTTTGGCTCTAAACGCATC|CCACTTGCCAGTAAGACCATAGTGACGTAG
ACACCGGGGAAACTGTGGGATTACGATTTG|GATTCTTAAAGCTACAGAGCCTTCTGGCCT
ATTAGGCCGGCTAATTGTTCTCGTGCGTCG|CATTTCTGTACGCACAGAGAAGGATCATAA
ATTTCTGTACGCACAGAGGGATTCCGGAGC|CAAAACGCATCAACTCATTTCTGTACGCAC
GGTCCTAAATCGCGTTAACCCAAACGCATC|TTGCGGAGTCTCCTTGCCTGTCATAGCGCA
ACTCATTTCTGTACGCACAGAAACGCATCA|CGCACAGAGGGATTCCGGAGCCAATGAGGA
TAAGACCATAGTGACGTAGCAGTTTCCAAA|CAAACGCATCAACTCATTTCTGTACGCACA
ATTTCTGTACGCACAGAACTAATGTCCGAT|TGTTACTGAAATGGATTAATTCTGTGGTCC
CTGTATTGCATCCCGTGGTAAACTGAGGAT|GGCCAAGTTGGTGTCGTGGTATATGGCGAG
CATTTCTGTACGCACAGAAACGCATCAACT|ACAGAGGGATTCCGGAGCCAATGAGGACGT
CAGGCTCGGAGCGGGGAGCATGGGATCCCG|ATCCTTCATAGGGTCCTAAATCGCGTTAAC
ACGTAGGTTTCAGCCCGCGCAAACGCATCA|TCACGCAATTATTTCGGTATATACGAACGA
CTCGTGCGTCGCGTAGCTTCATGCCCTGCC|AAGGATCATAAGTCGTACAGACCCAGAGTC
TTATCGTTTGGCTCTAAACGCATCAACTCA|GCCAGTAAGACCATAGTGACGTAGCAGTTT
TGTACGCACAGGCTCGGAGCGGGGAGCATG|AGCATCCTATCCTTCATAGGGTCCTAAATC
CCGGCGCGTGACGTAGGTTTCAGCCCGCGC|TGACCTGAGGTCACGCAATTATTTCGGTAT
AGAGGATTCTTAAAGCTACAGAGCCTTCTG|AGGTTTCAGCCCGCGCAAACGCATCAACTC
CATTTCTGTACGCACAGTATGTGACCTGCA|AGCCAAACGCATCAACTCATTTCTGTACGC
TGACCTGAGGTCACGCAATTATTTCGGTAT|AATGCCTTGCACCTGTATTGCATCCCGTGG
TCATTTCTGTACGCACAGAAACGCATCAAC|CACAGAGGGATTCCGGAGCCAATGAGGACG
AACATTAACATCCGGATTCCCTCAATGTCT|GGAGCCCAATCAATTAGGCCGGCTAATTGT
ACGCACAGAGAAGGATCATAAGTCGTACAG|AGTTCTTTGGGTAAAGATTTCGCCATCCGC
CCAGAGTCAGGTAATTAATGACCTGAGGTC|GACTGCGTCGTTGGTGTAAATGCCTTGCAC
AGACCCAGAGTCAGGTAATTAATGACCTGA|GCAGGACTGCGTCGTTGGTGTAAATGCCTT
CACAGAGGGATTCCGGAGCCAATGAGGACG|AACTCATTTCTGTACGCACAGTATGTGACC
ATAGGGTCCTAAATCGCGTTAACCCAAACG|GGGATTGCGGAGTCTCCTTGCCTGTCATAG
TTTCTGTACGCACAGAGTCCTCGCCACTTG|ATACTTAACCTCGGCGAAACGCATCAACTC
GCATCCTATCCTTCATAGGGTCCTAAATCG|TTTCTGTACGCACAGGGATTGCGGAGTCTC
GCAATACTCATACTTAACCTCGGCGAAACG|TGGAAACGCATCAACTCATTTCTGTACGCA
CAACTCATTTCTGTACGCACAGCAGCATCC|GCAGTTTCCAAACGCATCAACTCATTTCTG
TCAGGTAATTAATGACCTGAGGTCACGCAA|GTCGTTGGTGTAAATGCCTTGCACCTGTAT
AAACACAGTTGTTACTGAAATGGATTAATT|CATCAACTCATTTCTGTACGCACAGAGTCC
TGCATCCCGTGGTAAACTGAGGATAGAAAC|GTTGGTGTCGTGGTATATGGCGAGTCTTTC
CATCAACTCATTTCTGTACGCACAGTATGT|CATCTGACAGCCAAACGCATCAACTCATTT
TCAACTCATTTCTGTACGCACAGAGAAGGA|CGAATGGGGGGACTGAGTTCTTTGGGTAAA
ACCCAGAGTCAGGTAATTAATGACCTGAGG|AGGACTGCGTCGTTGGTGTAAATGCCTTGC
TGGGATCCCGAGATCCCAAACACAGTTGTT|TCGCGTTAACCCAAACGCATCAACTCATTT
CAGAACTAATGTCCGATCACGCTTCTTCGC|GATTAATTCTGTGGTCCTTATCGTTTGGCT
CTTCGCCTCCGAAGACGGCTAAACGCATCA|TTGGCTCTAAACGCATCAACTCATTTCTGT
CTGACAGCCAAACGCATCAACTCATTTCTG|TTCATGCCCTGCCCTAGTGCCGTCCGGCGC
ACAGAAACGCATCAACTCATTTCTGTACGC|GGAGCCAATGAGGACGTGGCAGGGGTGCGA
ATTCTGTGGTCCTTATCGTTTGGCTCTAAA|TCCTCGCCACTTGCCAGTAAGACCATAGTG
GGGATTACGATTTGCGTTGCCACTGAACAT|GAGCCTTCTGGCCTTGAGTCACAGCGGAGC
TCAACTCATTTCTGTACGCACAAACGCATC|CGAAAAGCACACAGGAGCGACCGGGAAGCG
TTTCTGTACGCACAGTGTACGCACAGCATG|CAGGGGTGCGATCCCGGCGCCGCCAAACGC
AAGCGAATGGGGGGACTGAGTTCTTTGGGT|AAGCCATGGGTGAGTTGAATGCCGCATCAA
CCGGGGAAACTGTGGGATTACGATTTGCGT|TCTTAAAGCTACAGAGCCTTCTGGCCTTGA
CGCGTGACGTAGGTTTCAGCCCGCGCAAAC|CTGAGGTCACGCAATTATTTCGGTATATAC
TGTCCGATCACGCTTCTTCGCCTCCGAAGA|TGTGGTCCTTATCGTTTGGCTCTAAACGCA
AGTCTCCTTGCCTGTCATAGCGCAATACTC|GCACAGCATGTTCCAGCCGTATGGAAACGC
GTAAGACCATAGTGACGTAGCAGTTTCCAA|TCAAACGCATCAACTCATTTCTGTACGCAC
GGACTGAGTTCTTTGGGTAAAGATTTCGCC|AGTTGAATGCCGCATCAAGACCCTGCACCA
AGAAACGCATCAACTCATTTCTGTACGCAC|AGCCAATGAGGACGTGGCAGGGGTGCGATC
CTCATACTTAACCTCGGCGAAACGCATCAA|CGCATCAACTCATTTCTGTACGCACAAACG
GACCCAGAGTCAGGTAATTAATGACCTGAG|CAGGACTGCGTCGTTGGTGTAAATGCCTTG
GAGGACGTGGCAGGGGTGCGATCCCGGCGC|TGTGACCTGCAATGGATACACCGGGGAAAC
CGCACAGGGATTGCGGAGTCTCCTTGCCTG|TGTACGCACAGTGTACGCACAGCATGTTCC
ATTTCTGTACGCACAGAAACGCATCAACTC|CAGAGGGATTCCGGAGCCAATGAGGACGTG
GAGCGGGGAGCATGGGATCCCGAGATCCCA|TAGGGTCCTAAATCGCGTTAACCCAAACGC
ATCAACTCATTTCTGTACGCACAGAACTAA|AACACAGTTGTTACTGAAATGGATTAATTC
CAGGGGTGCGATCCCGGCGCCGCCAAACGC|AATGGATACACCGGGGAAACTGTGGGATTA
TGTTACTGAAATGGATTAATTCTGTGGTCC|ATTTCTGTACGCACAGAGTCCTCGCCACTT
ACAGAGAAGGATCATAAGTCGTACAGACCC|CTTTGGGTAAAGATTTCGCCATCCGCAGGA
GATCCCAAACACAGTTGTTACTGAAATGGA|CAAACGCATCAACTCATTTCTGTACGCACA
ACGCATCAACTCATTTCAAACGCATCAACT|GCACAAACGCATCAACTCATTTCTGTACGC
CGCACAGTATGTGACCTGCAATGGATACAC|ATCAACTCATTTCTGTACGCACAGAGGATT
TCGGCGAAACGCATCAACTCATTTCAAACG|TTCTGTACGCACAAACGCATCAACTCATTT
CGCACAGCATGTTCCAGCCGTATGGAAACG|CCGCCAAACGCATCAACTCATTTCTGTACG
ATCAACTCATTTCTGTACGCACAGTGTACG|AGGACGTGGCAGGGGTGCGATCCCGGCGCC
CAATGAGGACGTGGCAGGGGTGCGATCCCG|AGTATGTGACCTGCAATGGATACACCGGGG
AAGGATCATAAGTCGTACAGACCCAGAGTC|GTAAAGATTTCGCCATCCGCAGGACTGCGT
TCATTTCTGTACGCACAAACGCATCAACTC|CAAGCGCCTACTGCACGTGGGTCACACCGG
CGCACAGAGTCCTCGCCACTTGCCAGTAAG|CCTCGGCGAAACGCATCAACTCATTTCAAA
ACGAACGAAAAGCACACAGGAGCGACCGGG|AACTGAGGATAGAAACGATGCGCCTAATAA
ACAGAACTAATGTCCGATCACGCTTCTTCG|GGATTAATTCTGTGGTCCTTATCGTTTGGC
ATCTGACAGCCAAACGCATCAACTCATTTC|GCTTCATGCCCTGCCCTAGTGCCGTCCGGC
TTGTTCTCGTGCGTCGCGTAGCTTCATGCC|CAGAGAAGGATCATAAGTCGTACAGACCCA
TCATTTCTGTACGCACAAACGCATCAACTC|AGCACACAGGAGCGACCGGGAAGCGAATGG
GGCCCGGGCGGACATCTGACAGCCAAACGC|CGTGCGTCGCGTAGCTTCATGCCCTGCCCT
GGCAAAACGCATCAACTCATTTCTGTACGC|CCGGGCGGACATCTGACAGCCAAACGCATC
TACTGAAATGGATTAATTCTGTGGTCCTTA|TCTGTACGCACAGAGTCCTCGCCACTTGCC
GGGAGCATGGGATCCCGAGATCCCAAACAC|TCCTAAATCGCGTTAACCCAAACGCATCAA
CGCATCAACTCATTTCTGTACGCACAAACG|CGCACAGGTCAAGCGCCTACTGCACGTGGG
AACTAATGTCCGATCACGCTTCTTCGCCTC|TAATTCTGTGGTCCTTATCGTTTGGCTCTA
ACAGGGATTGCGGAGTCTCCTTGCCTGTCA|ACGCACAGTGTACGCACAGCATGTTCCAGC
ATGGGATCCCGAGATCCCAAACACAGTTGT|ATCGCGTTAACCCAAACGCATCAACTCATT
GCCGCCAAACGCATCAACTCATTTCTGTAC|ACTGTGGGATTACGATTTGCGTTGCCACTG
ATCAACTCATTTCTGTACGCACAGGCTCGG|CTGTACGCACAGCAGCATCCTATCCTTCAT
CCTAAATCGCGTTAACCCAAACGCATCAAC|CGGAGTCTCCTTGCCTGTCATAGCGCAATA
TGCAATGGATACACCGGGGAAACTGTGGGA|ACGCACAGAGGATTCTTAAAGCTACAGAGC
AAACGCATCAACTCATTTCTGTACGCACAG|TCATTTCTGTACGCACAGCAGCATCCTATC
GCGTTAACCCAAACGCATCAACTCATTTCT|CCTTGCCTGTCATAGCGCAATACTCATACT
TTAATTCTGTGGTCCTTATCGTTTGGCTCT|GAGTCCTCGCCACTTGCCAGTAAGACCATA
GAAATGGATTAATTCTGTGGTCCTTATCGT|TACGCACAGAGTCCTCGCCACTTGCCAGTA
GAGTCCTCGCCACTTGCCAGTAAGACCATA|CGAAACGCATCAACTCATTTCAAACGCATC
TACGCACAGGCTCGGAGCGGGGAGCATGGG|CATCCTATCCTTCATAGGGTCCTAAATCGC
CATTTCTGTACGCACAGAGAAGGATCATAA|GGGGGACTGAGTTCTTTGGGTAAAGATTTC
AGCAGCATCCTATCCTTCATAGGGTCCTAA|CTCATTTCTGTACGCACAGGGATTGCGGAG
CGGGCGGACATCTGACAGCCAAACGCATCA|CGTCGCGTAGCTTCATGCCCTGCCCTAGTG
TCAACTCATTTCTGTACGCACAGAGGATTC|GTGCCGTCCGGCGCGTGACGTAGGTTTCAG
CCGCAGGACTGCGTCGTTGGTGTAAATGCC|GAAGTAAGATAAAGCAGACTGCTTAGAGCG
CCAAACGCATCAACTCATTTCTGTACGCAC|CCTGCCCTAGTGCCGTCCGGCGCGTGACGT
CCTGTCATAGCGCAATACTCATACTTAACC|TTCCAGCCGTATGGAAACGCATCAACTCAT
CATCAACTCATTTCTGTACGCACAGAACTA|AAACACAGTTGTTACTGAAATGGATTAATT
GCACAGCATGTTCCAGCCGTATGGAAACGC|CGCCAAACGCATCAACTCATTTCTGTACGC
CGTAGGTTTCAGCCCGCGCAAACGCATCAA|CACGCAATTATTTCGGTATATACGAACGAA
CTCCTTGCCTGTCATAGCGCAATACTCATA|CAGCATGTTCCAGCCGTATGGAAACGCATC
TACGCACAGAGGATTCTTAAAGCTACAGAG|GTGACGTAGGTTTCAGCCCGCGCAAACGCA
CAGAGCCTTCTGGCCTTGAGTCACAGCGGA|ACGCATCAACTCATTTCTGTACGCACAAAC
GGATTCCCTCAATGTCTGCTGGCCCGGGCG|TTAGGCCGGCTAATTGTTCTCGTGCGTCGC
CATTTCTGTACGCACAGGCTCGGAGCGGGG|CACAGCAGCATCCTATCCTTCATAGGGTCC
ACAGAGGGATTCCGGAGCCAATGAGGACGT|ACTCATTTCTGTACGCACAGTATGTGACCT
ACGCAATTATTTCGGTATATACGAACGAAA|CTGTATTGCATCCCGTGGTAAACTGAGGAT
CAAACGCATCAACTCATTTCTGTACGCACA|TCATTTCTGTACGCACAGAGGGATTCCGGA
TCTGTACGCACAGTATGTGACCTGCAATGG|AAACGCATCAACTCATTTCTGTACGCACAG
CTTGAGTCACAGCGGAGCCCAATCAATTAG|TTCTGTACGCACAAACGCATCAACTCATTT
TGTGGTCCTTATCGTTTGGCTCTAAACGCA|CGCCACTTGCCAGTAAGACCATAGTGACGT
CTCATTTCTGTACGCACAGAGAAGGATCAT|TGGGGGGACTGAGTTCTTTGGGTAAAGATT
TCTGTACGCACAGCAGCATCCTATCCTTCA|AAACGCATCAACTCATTTCTGTACGCACAG
GTATTGCATCCCGTGGTAAACTGAGGATAG|CCAAGTTGGTGTCGTGGTATATGGCGAGTC
GTTCTTTGGGTAAAGATTTCGCCATCCGCA|TGCCGCATCAAGACCCTGCACCAGGGAAGT
TTCTGTACGCACAGGCTCGGAGCGGGGAGC|AGCAGCATCCTATCCTTCATAGGGTCCTAA
TGCCACTGAACATTAACATCCGGATTCCCT|GTCACAGCGGAGCCCAATCAATTAGGCCGG
TCGTTTGGCTCTAAACGCATCAACTCATTT|AGTAAGACCATAGTGACGTAGCAGTTTCCA
TCTGGCCTTGAGTCACAGCGGAGCCCAATC|ACTCATTTCTGTACGCACAAACGCATCAAC
ACATTAACATCCGGATTCCCTCAATGTCTG|GAGCCCAATCAATTAGGCCGGCTAATTGTT
CTGAGTTCTTTGGGTAAAGATTTCGCCATC|TGAATGCCGCATCAAGACCCTGCACCAGGG
TTCCAAACGCATCAACTCATTTCTGTACGC|ACGCACAGAAACGCATCAACTCATTTCTGT
ATTTCTGTACGCACAGAGAAGGATCATAAG|GGGGACTGAGTTCTTTGGGTAAAGATTTCG
CTGTACGCACAGTATGTGACCTGCAATGGA|AACGCATCAACTCATTTCTGTACGCACAGA
AGCGAATGGGGGGACTGAGTTCTTTGGGTA|AGCCATGGGTGAGTTGAATGCCGCATCAAG
CACTTGCCAGTAAGACCATAGTGACGTAGC|CAACTCATTTCAAACGCATCAACTCATTTC
CACAAACGCATCAACTCATTTCTGTACGCA|GACCGGGAAGCGAATGGGGGGACTGAGTTC
CATTTCTGTACGCACAGAACTAATGTCCGA|TTGTTACTGAAATGGATTAATTCTGTGGTC
ACTGAGTTCTTTGGGTAAAGATTTCGCCAT|TTGAATGCCGCATCAAGACCCTGCACCAGG
GCTTCTTCGCCTCCGAAGACGGCTAAACGC|TCGTTTGGCTCTAAACGCATCAACTCATTT
TTCGCCATCCGCAGGACTGCGTCGTTGGTG|GCACCAGGGAAGTAAGATAAAGCAGACTGC
TACGCACAGAGAAGGATCATAAGTCGTACA|GAGTTCTTTGGGTAAAGATTTCGCCATCCG
TGTTCCAGCCGTATGGAAACGCATCAACTC|GCATCAACTCATTTCTGTACGCACAGGTCA
AAGACGGCTAAACGCATCAACTCATTTCTG|CGCATCAACTCATTTCTGTACGCACAGCAG
CAGTATGTGACCTGCAATGGATACACCGGG|ACTCATTTCTGTACGCACAGAGGATTCTTA
GAGATCCCAAACACAGTTGTTACTGAAATG|CCCAAACGCATCAACTCATTTCTGTACGCA
AACGCATCAACTCATTTCAAACGCATCAAC|CGCACAAACGCATCAACTCATTTCTGTACG
AAACGCATCAACTCATTTCTGTACGCACAG|ACAGAAACGCATCAACTCATTTCTGTACGC
ATACTTAACCTCGGCGAAACGCATCAACTC|ATCAACTCATTTCTGTACGCACAAACGCAT
CCAAACACAGTTGTTACTGAAATGGATTAA|CGCATCAACTCATTTCTGTACGCACAGAGT
GCACAGCAGCATCCTATCCTTCATAGGGTC|TCAACTCATTTCTGTACGCACAGGGATTGC
GTAGCAGTTTCCAAACGCATCAACTCATTT|ATTTCTGTACGCACAGAAACGCATCAACTC
TACGATTTGCGTTGCCACTGAACATTAACA|TTCTGGCCTTGAGTCACAGCGGAGCCCAAT
GACATCTGACAGCCAAACGCATCAACTCAT|GTAGCTTCATGCCCTGCCCTAGTGCCGTCC
TCAGCCCGCGCAAACGCATCAACTCATTTC|TATTTCGGTATATACGAACGAAAAGCACAC
ATTAATGACCTGAGGTCACGCAATTATTTC|GTGTAAATGCCTTGCACCTGTATTGCATCC
CAAACGCATCAACTCATTTCTGTACGCACA|CCGGGAAGCGAATGGGGGGACTGAGTTCTT
AACTCATTTCAAACGCATCAACTCATTTCT|CGCATCAACTCATTTCTGTACGCACAGAGG
GTCACACCGGCAAAACGCATCAACTCATTT|CTGCTGGCCCGGGCGGACATCTGACAGCCA
CCGGCTAATTGTTCTCGTGCGTCGCGTAGC|TGTACGCACAGAGAAGGATCATAAGTCGTA
CGTAGCTTCATGCCCTGCCCTAGTGCCGTC|GTCGTACAGACCCAGAGTCAGGTAATTAAT
CAACTCATTTCTGTACGCACAGGCTCGGAG|GTACGCACAGCAGCATCCTATCCTTCATAG
TATCCTTCATAGGGTCCTAAATCGCGTTAA|TACGCACAGGGATTGCGGAGTCTCCTTGCC
CCGGCAAAACGCATCAACTCATTTCTGTAC|GCCCGGGCGGACATCTGACAGCCAAACGCA
CAACTCATTTCTGTACGCACAGTATGTGAC|CTGACAGCCAAACGCATCAACTCATTTCTG
AACTGAGGATAGAAACGATGCGCCTAATAA|ATATGGCGAGTCTTTCGTTCTAATAGTACG
GCGCAAACGCATCAACTCATTTCTGTACGC|GTATATACGAACGAAAAGCACACAGGAGCG
ATGGGGGGACTGAGTTCTTTGGGTAAAGAT|TGGGTGAGTTGAATGCCGCATCAAGACCCT
GGAAGCGAATGGGGGGACTGAGTTCTTTGG|AAAAGCCATGGGTGAGTTGAATGCCGCATC
GTATGGAAACGCATCAACTCATTTCTGTAC|ATTTCTGTACGCACAGGTCAAGCGCCTACT
CTGTACGCACAGAGTCCTCGCCACTTGCCA|CTTAACCTCGGCGAAACGCATCAACTCATT
GAGCATGGGATCCCGAGATCCCAAACACAG|CTAAATCGCGTTAACCCAAACGCATCAACT
ACCCAAACGCATCAACTCATTTCTGTACGC|CTGTCATAGCGCAATACTCATACTTAACCT
CCGCCAAACGCATCAACTCATTTCTGTACG|CTGTGGGATTACGATTTGCGTTGCCACTGA
GCATCAACTCATTTCTGTACGCACAGAGGG|GTCACACCGGCAAAACGCATCAACTCATTT
ACGCATCAACTCATTTCTGTACGCACAGAA|TTTCTGTACGCACAGAGGGATTCCGGAGCC
CGAAACGCATCAACTCATTTCAAACGCATC|GTACGCACAAACGCATCAACTCATTTCTGT
ATCAACTCATTTCTGTACGCACAGAGGGAT|CACACCGGCAAAACGCATCAACTCATTTCT
TCTGTACGCACAGGTCAAGCGCCTACTGCA|GCCACTGAACATTAACATCCGGATTCCCTC
CCGAAGACGGCTAAACGCATCAACTCATTT|AAACGCATCAACTCATTTCTGTACGCACAG
CGCACAGAACTAATGTCCGATCACGCTTCT|AATGGATTAATTCTGTGGTCCTTATCGTTT
GAAAAGCACACAGGAGCGACCGGGAAGCGA|GGATAGAAACGATGCGCCTAATAAAAGCCA
CCTTGAGTCACAGCGGAGCCCAATCAATTA|TTTCTGTACGCACAAACGCATCAACTCATT
CCAGCCGTATGGAAACGCATCAACTCATTT|CAACTCATTTCTGTACGCACAGGTCAAGCG
CAGCATCCTATCCTTCATAGGGTCCTAAAT|CATTTCTGTACGCACAGGGATTGCGGAGTC
CGTTTGGCTCTAAACGCATCAACTCATTTC|GTAAGACCATAGTGACGTAGCAGTTTCCAA
CAACTCATTTCTGTACGCACAGAACTAATG|CACAGTTGTTACTGAAATGGATTAATTCTG
CAAACGCATCAACTCATTTCTGTACGCACA|TCATAGCGCAATACTCATACTTAACCTCGG
CATCAACTCATTTCTGTACGCACAGGGATT|AACGCATCAACTCATTTCTGTACGCACAGT
AGGTCACGCAATTATTTCGGTATATACGAA|TGCACCTGTATTGCATCCCGTGGTAAACTG
TAAACGCATCAACTCATTTCTGTACGCACA|CTCATTTCTGTACGCACAGCAGCATCCTAT
ATTTCAAACGCATCAACTCATTTCTGTACG|CAACTCATTTCTGTACGCACAGAGGGATTC
CACTGAACATTAACATCCGGATTCCCTCAA|ACAGCGGAGCCCAATCAATTAGGCCGGCTA
ATCAACTCATTTCTGTACGCACAAACGCAT|ACAGGTCAAGCGCCTACTGCACGTGGGTCA
GGACATCTGACAGCCAAACGCATCAACTCA|CGTAGCTTCATGCCCTGCCCTAGTGCCGTC
AACGCATCAACTCATTTCTGTACGCACAGA|GCCCTAGTGCCGTCCGGCGCGTGACGTAGG
TTGGCTCTAAACGCATCAACTCATTTCTGT|AGACCATAGTGACGTAGCAGTTTCCAAACG
CGGATTCCCTCAATGTCTGCTGGCCCGGGC|ATTAGGCCGGCTAATTGTTCTCGTGCGTCG
TTTCTGTACGCACAGGCTCGGAGCGGGGAG|CAGCAGCATCCTATCCTTCATAGGGTCCTA
ACGTAGCAGTTTCCAAACGCATCAACTCAT|TCATTTCTGTACGCACAGAAACGCATCAAC
CACAGGTCAAGCGCCTACTGCACGTGGGTC|ACATTAACATCCGGATTCCCTCAATGTCTG
TCCCGAGATCCCAAACACAGTTGTTACTGA|TTAACCCAAACGCATCAACTCATTTCTGTA
GGTCAAGCGCCTACTGCACGTGGGTCACAC|TAACATCCGGATTCCCTCAATGTCTGCTGG
AGCCTTCTGGCCTTGAGTCACAGCGGAGCC|CATCAACTCATTTCTGTACGCACAAACGCA
AGGGATTGCGGAGTCTCCTTGCCTGTCATA|GCACAGTGTACGCACAGCATGTTCCAGCCG
TGTACGCACAGCAGCATCCTATCCTTCATA|ACGCATCAACTCATTTCTGTACGCACAGGG
TCTGTACGCACAGTGTACGCACAGCATGTT|GGGGTGCGATCCCGGCGCCGCCAAACGCAT
AACGCATCAACTCATTTCTGTACGCACAGA|TGGGTCACACCGGCAAAACGCATCAACTCA
GCCCGGGCGGACATCTGACAGCCAAACGCA|GTGCGTCGCGTAGCTTCATGCCCTGCCCTA
CAAACGCATCAACTCATTTCTGTACGCACA|GGGATTACGATTTGCGTTGCCACTGAACAT
ACGCATCAACTCATTTCTGTACGCACAGAG|CCCTAGTGCCGTCCGGCGCGTGACGTAGGT
AGAGCCTTCTGGCCTTGAGTCACAGCGGAG|CGCATCAACTCATTTCTGTACGCACAAACG
GCGTAGCTTCATGCCCTGCCCTAGTGCCGT|AGTCGTACAGACCCAGAGTCAGGTAATTAA
ATTTCTGTACGCACAGAGGATTCTTAAAGC|CCGGCGCGTGACGTAGGTTTCAGCCCGCGC
CGAACGAAAAGCACACAGGAGCGACCGGGA|ACTGAGGATAGAAACGATGCGCCTAATAAA
ATGGAAACGCATCAACTCATTTCTGTACGC|TTCTGTACGCACAGGTCAAGCGCCTACTGC
TCCTATCCTTCATAGGGTCCTAAATCGCGT|CTGTACGCACAGGGATTGCGGAGTCTCCTT
ACTCATTTCTGTACGCACAGAACTAATGTC|CAGTTGTTACTGAAATGGATTAATTCTGTG
CAGGTAATTAATGACCTGAGGTCACGCAAT|TCGTTGGTGTAAATGCCTTGCACCTGTATT
CTGTACGCACAGGCTCGGAGCGGGGAGCAT|CAGCATCCTATCCTTCATAGGGTCCTAAAT
GCGGGGAGCATGGGATCCCGAGATCCCAAA|GGGTCCTAAATCGCGTTAACCCAAACGCAT
TAACCTCGGCGAAACGCATCAACTCATTTC|CTCATTTCTGTACGCACAAACGCATCAACT
TAATGACCTGAGGTCACGCAATTATTTCGG|GTAAATGCCTTGCACCTGTATTGCATCCCG
TTCTGTACGCACAGTATGTGACCTGCAATG|CAAACGCATCAACTCATTTCTGTACGCACA
GTCACGCAATTATTTCGGTATATACGAACG|CACCTGTATTGCATCCCGTGGTAAACTGAG
TACACCGGGGAAACTGTGGGATTACGATTT|GGATTCTTAAAGCTACAGAGCCTTCTGGCC
TACGCACAGAACTAATGTCCGATCACGCTT|GAAATGGATTAATTCTGTGGTCCTTATCGT
GTCCTTATCGTTTGGCTCTAAACGCATCAA|ACTTGCCAGTAAGACCATAGTGACGTAGCA
TAGCTTCATGCCCTGCCCTAGTGCCGTCCG|CGTACAGACCCAGAGTCAGGTAATTAATGA
GACCTGCAATGGATACACCGGGGAAACTGT|CTGTACGCACAGAGGATTCTTAAAGCTACA
CAATTATTTCGGTATATACGAACGAAAAGC|TATTGCATCCCGTGGTAAACTGAGGATAGA
ACTGTGGGATTACGATTTGCGTTGCCACTG|CTACAGAGCCTTCTGGCCTTGAGTCACAGC
GCAGCATCCTATCCTTCATAGGGTCCTAAA|TCATTTCTGTACGCACAGGGATTGCGGAGT
GGATACACCGGGGAAACTGTGGGATTACGA|AGAGGATTCTTAAAGCTACAGAGCCTTCTG
CATTTCTGTACGCACAGCAGCATCCTATCC|TTCCAAACGCATCAACTCATTTCTGTACGC
TCTGTACGCACAGAGGGATTCCGGAGCCAA|AACGCATCAACTCATTTCTGTACGCACAGT
CAGCCCGCGCAAACGCATCAACTCATTTCT|ATTTCGGTATATACGAACGAAAAGCACACA
ATTTCTGTACGCACAGTATGTGACCTGCAA|GCCAAACGCATCAACTCATTTCTGTACGCA
AAACGCATCAACTCATTTCAAACGCATCAA|ACGCACAAACGCATCAACTCATTTCTGTAC
TCTGTGGTCCTTATCGTTTGGCTCTAAACG|CTCGCCACTTGCCAGTAAGACCATAGTGAC
AACATCCGGATTCCCTCAATGTCTGCTGGC|CAATCAATTAGGCCGGCTAATTGTTCTCGT
AACTCATTTCTGTACGCACAGAGGATTCTT|GCCGTCCGGCGCGTGACGTAGGTTTCAGCC
GGCTAAACGCATCAACTCATTTCTGTACGC|CAACTCATTTCTGTACGCACAGCAGCATCC
GCATCAACTCATTTCTGTACGCACAGAGAA|AAGCGAATGGGGGGACTGAGTTCTTTGGGT
GAAGACGGCTAAACGCATCAACTCATTTCT|ACGCATCAACTCATTTCTGTACGCACAGCA
AGCACACAGGAGCGACCGGGAAGCGAATGG|AGAAACGATGCGCCTAATAAAAGCCATGGG
GGGACTGAGTTCTTTGGGTAAAGATTTCGC|GAGTTGAATGCCGCATCAAGACCCTGCACC
GGACTGCGTCGTTGGTGTAAATGCCTTGCA|AAGATAAAGCAGACTGCTTAGAGCGTCCGA
TCTGTACGCACAGGGATTGCGGAGTCTCCT|CATTTCTGTACGCACAGTGTACGCACAGCA
CTCATTTCTGTACGCACAGAGTCCTCGCCA|ACTCATACTTAACCTCGGCGAAACGCATCA
CATCAACTCATTTCTGTACGCACAAACGCA|AACGAAAAGCACACAGGAGCGACCGGGAAG
GTACGCACAGAGAAGGATCATAAGTCGTAC|TGAGTTCTTTGGGTAAAGATTTCGCCATCC
TTCTGTACGCACAGAACTAATGTCCGATCA|TTACTGAAATGGATTAATTCTGTGGTCCTT
CTCGGCGAAACGCATCAACTCATTTCAAAC|TTTCTGTACGCACAAACGCATCAACTCATT
GGTAATTAATGACCTGAGGTCACGCAATTA|GTTGGTGTAAATGCCTTGCACCTGTATTGC
TCGGAGCGGGGAGCATGGGATCCCGAGATC|TCATAGGGTCCTAAATCGCGTTAACCCAAA
CTTGCACCTGTATTGCATCCCGTGGTAAAC|GTCCGAAGGCCAAGTTGGTGTCGTGGTATA
ACCGGCAAAACGCATCAACTCATTTCTGTA|GGCCCGGGCGGACATCTGACAGCCAAACGC
CGTAGCAGTTTCCAAACGCATCAACTCATT|CATTTCTGTACGCACAGAAACGCATCAACT
GCACAGAAACGCATCAACTCATTTCTGTAC|CCGGAGCCAATGAGGACGTGGCAGGGGTGC
GGTCACACCGGCAAAACGCATCAACTCATT|TCTGCTGGCCCGGGCGGACATCTGACAGCC
TCTCGTGCGTCGCGTAGCTTCATGCCCTGC|GAAGGATCATAAGTCGTACAGACCCAGAGT
CTAATGTCCGATCACGCTTCTTCGCCTCCG|ATTCTGTGGTCCTTATCGTTTGGCTCTAAA
ACGCACAAACGCATCAACTCATTTCTGTAC|AGCGACCGGGAAGCGAATGGGGGGACTGAG
ACAGGTCAAGCGCCTACTGCACGTGGGTCA|CATTAACATCCGGATTCCCTCAATGTCTGC
AGGATCATAAGTCGTACAGACCCAGAGTCA|TAAAGATTTCGCCATCCGCAGGACTGCGTC
CTCATTTCTGTACGCACAGAAACGCATCAA|GCACAGAGGGATTCCGGAGCCAATGAGGAC
GCTAAACGCATCAACTCATTTCTGTACGCA|AACTCATTTCTGTACGCACAGCAGCATCCT
CGCGTAGCTTCATGCCCTGCCCTAGTGCCG|AAGTCGTACAGACCCAGAGTCAGGTAATTA
CGGACATCTGACAGCCAAACGCATCAACTC|GCGTAGCTTCATGCCCTGCCCTAGTGCCGT
GCCCGCGCAAACGCATCAACTCATTTCTGT|TTCGGTATATACGAACGAAAAGCACACAGG
CGACCGGGAAGCGAATGGGGGGACTGAGTT|CCTAATAAAAGCCATGGGTGAGTTGAATGC
GCACAGGGATTGCGGAGTCTCCTTGCCTGT|GTACGCACAGTGTACGCACAGCATGTTCCA
TGTACGCACAGAGTCCTCGCCACTTGCCAG|TTAACCTCGGCGAAACGCATCAACTCATTT
CATTTCTGTACGCACAGGTCAAGCGCCTAC|CGTTGCCACTGAACATTAACATCCGGATTC
GTGACCTGCAATGGATACACCGGGGAAACT|TTCTGTACGCACAGAGGATTCTTAAAGCTA
TCAACTCATTTCTGTACGCACAGAGTCCTC|CAATACTCATACTTAACCTCGGCGAAACGC
ATCAACTCATTTCTGTACGCACAGCAGCAT|TAGCAGTTTCCAAACGCATCAACTCATTTC
GTATATACGAACGAAAAGCACACAGGAGCG|GTGGTAAACTGAGGATAGAAACGATGCGCC
CCACTTGCCAGTAAGACCATAGTGACGTAG|TCAACTCATTTCAAACGCATCAACTCATTT
CACAGGAGCGACCGGGAAGCGAATGGGGGG|ACGATGCGCCTAATAAAAGCCATGGGTGAG
GAGCCTTCTGGCCTTGAGTCACAGCGGAGC|GCATCAACTCATTTCTGTACGCACAAACGC
CGCATCAACTCATTTCTGTACGCACAGGGA|GAAACGCATCAACTCATTTCTGTACGCACA
AGTCAGGTAATTAATGACCTGAGGTCACGC|GCGTCGTTGGTGTAAATGCCTTGCACCTGT
CACGCTTCTTCGCCTCCGAAGACGGCTAAA|TTATCGTTTGGCTCTAAACGCATCAACTCA
TCTGTACGCACAGGCTCGGAGCGGGGAGCA|GCAGCATCCTATCCTTCATAGGGTCCTAAA
ACAGCAGCATCCTATCCTTCATAGGGTCCT|AACTCATTTCTGTACGCACAGGGATTGCGG
GCATGGGATCCCGAGATCCCAAACACAGTT|AAATCGCGTTAACCCAAACGCATCAACTCA
GTGGCAGGGGTGCGATCCCGGCGCCGCCAA|CTGCAATGGATACACCGGGGAAACTGTGGG
GCATCCCGTGGTAAACTGAGGATAGAAACG|TTGGTGTCGTGGTATATGGCGAGTCTTTCG
CAACTCATTTCTGTACGCACAGAAACGCAT|TACGCACAGAGGGATTCCGGAGCCAATGAG
TGAGTTCTTTGGGTAAAGATTTCGCCATCC|GAATGCCGCATCAAGACCCTGCACCAGGGA
TACGCACAGAGGGATTCCGGAGCCAATGAG|CATCAACTCATTTCTGTACGCACAGTATGT
CGTGGTAAACTGAGGATAGAAACGATGCGC|TCGTGGTATATGGCGAGTCTTTCGTTCTAA
ACTTAACCTCGGCGAAACGCATCAACTCAT|CAACTCATTTCTGTACGCACAAACGCATCA
CAGGTCAAGCGCCTACTGCACGTGGGTCAC|ATTAACATCCGGATTCCCTCAATGTCTGCT
AGGATTCTTAAAGCTACAGAGCCTTCTGGC|GTTTCAGCCCGCGCAAACGCATCAACTCAT
ACTCATTTCTGTACGCACAAACGCATCAAC|GTCAAGCGCCTACTGCACGTGGGTCACACC
GCGACCGGGAAGCGAATGGGGGGACTGAGT|GCCTAATAAAAGCCATGGGTGAGTTGAATG
TTAACCCAAACGCATCAACTCATTTCTGTA|TGCCTGTCATAGCGCAATACTCATACTTAA
AAACGCATCAACTCATTTCTGTACGCACAG|TGCCCTAGTGCCGTCCGGCGCGTGACGTAG
TTCTGTACGCACAGAAACGCATCAACTCAT|GAGGGATTCCGGAGCCAATGAGGACGTGGC
TCATAGCGCAATACTCATACTTAACCTCGG|AGCCGTATGGAAACGCATCAACTCATTTCT
TACGCACAGGGATTGCGGAGTCTCCTTGCC|TCTGTACGCACAGTGTACGCACAGCATGTT
GTACAGACCCAGAGTCAGGTAATTAATGAC|ATCCGCAGGACTGCGTCGTTGGTGTAAATG
CAATCAATTAGGCCGGCTAATTGTTCTCGT|TCAACTCATTTCTGTACGCACAGAGAAGGA
TGCGGAGTCTCCTTGCCTGTCATAGCGCAA|TGTACGCACAGCATGTTCCAGCCGTATGGA
TGCACCTGTATTGCATCCCGTGGTAAACTG|CCGAAGGCCAAGTTGGTGTCGTGGTATATG
CGGCAAAACGCATCAACTCATTTCTGTACG|CCCGGGCGGACATCTGACAGCCAAACGCAT
CGCACAGAGGATTCTTAAAGCTACAGAGCC|GACGTAGGTTTCAGCCCGCGCAAACGCATC
TTCTGGCCTTGAGTCACAGCGGAGCCCAAT|AACTCATTTCTGTACGCACAAACGCATCAA
GGGGACTGAGTTCTTTGGGTAAAGATTTCG|TGAGTTGAATGCCGCATCAAGACCCTGCAC
GCCTTGCACCTGTATTGCATCCCGTGGTAA|GCGTCCGAAGGCCAAGTTGGTGTCGTGGTA
GGTTTCAGCCCGCGCAAACGCATCAACTCA|CAATTATTTCGGTATATACGAACGAAAAGC
ATGTCTGCTGGCCCGGGCGGACATCTGACA|AATTGTTCTCGTGCGTCGCGTAGCTTCATG
TTGGGTAAAGATTTCGCCATCCGCAGGACT|CATCAAGACCCTGCACCAGGGAAGTAAGAT
ACGCACAGAGGGATTCCGGAGCCAATGAGG|ATCAACTCATTTCTGTACGCACAGTATGTG
AAAACGCATCAACTCATTTCTGTACGCACA|GGCGGACATCTGACAGCCAAACGCATCAAC
CACGTGGGTCACACCGGCAAAACGCATCAA|TCAATGTCTGCTGGCCCGGGCGGACATCTG
TTCTTCGCCTCCGAAGACGGCTAAACGCAT|GTTTGGCTCTAAACGCATCAACTCATTTCT
ATAGCGCAATACTCATACTTAACCTCGGCG|CCGTATGGAAACGCATCAACTCATTTCTGT
TCAACTCATTTCTGTACGCACAGTGTACGC|GGACGTGGCAGGGGTGCGATCCCGGCGCCG
CCCGCGCAAACGCATCAACTCATTTCTGTA|TCGGTATATACGAACGAAAAGCACACAGGA
TCTTTGGGTAAAGATTTCGCCATCCGCAGG|CCGCATCAAGACCCTGCACCAGGGAAGTAA
GTTCTCGTGCGTCGCGTAGCTTCATGCCCT|GAGAAGGATCATAAGTCGTACAGACCCAGA
ACAAACGCATCAACTCATTTCTGTACGCAC|ACGTGGGTCACACCGGCAAAACGCATCAAC
GTGGGTCACACCGGCAAAACGCATCAACTC|ATGTCTGCTGGCCCGGGCGGACATCTGACA
ACAGAGTCCTCGCCACTTGCCAGTAAGACC|CGGCGAAACGCATCAACTCATTTCAAACGC
TAGCAGTTTCCAAACGCATCAACTCATTTC|TTTCTGTACGCACAGAAACGCATCAACTCA
GAGCCAATGAGGACGTGGCAGGGGTGCGAT|GCACAGTATGTGACCTGCAATGGATACACC
CATTTCTGTACGCACAAACGCATCAACTCA|AAGCGCCTACTGCACGTGGGTCACACCGGC
AATCAATTAGGCCGGCTAATTGTTCTCGTG|CAACTCATTTCTGTACGCACAGAGAAGGAT
TTCTGTACGCACAAACGCATCAACTCATTT|CACAGGAGCGACCGGGAAGCGAATGGGGGG
TGTGGGATTACGATTTGCGTTGCCACTGAA|ACAGAGCCTTCTGGCCTTGAGTCACAGCGG
TGCCCTGCCCTAGTGCCGTCCGGCGCGTGA|CCCAGAGTCAGGTAATTAATGACCTGAGGT
GCGCCTACTGCACGTGGGTCACACCGGCAA|CCGGATTCCCTCAATGTCTGCTGGCCCGGG
ACCGGGGAAACTGTGGGATTACGATTTGCG|TTCTTAAAGCTACAGAGCCTTCTGGCCTTG
CTACAGAGCCTTCTGGCCTTGAGTCACAGC|CAAACGCATCAACTCATTTCTGTACGCACA
CCAATGAGGACGTGGCAGGGGTGCGATCCC|CAGTATGTGACCTGCAATGGATACACCGGG
AATTCTGTGGTCCTTATCGTTTGGCTCTAA|GTCCTCGCCACTTGCCAGTAAGACCATAGT
CCCAAACGCATCAACTCATTTCTGTACGCA|TGTCATAGCGCAATACTCATACTTAACCTC
GCCAGTAAGACCATAGTGACGTAGCAGTTT|CATTTCAAACGCATCAACTCATTTCTGTAC
TTCTTAAAGCTACAGAGCCTTCTGGCCTTG|CAGCCCGCGCAAACGCATCAACTCATTTCT
CGGGGAAACTGTGGGATTACGATTTGCGTT|CTTAAAGCTACAGAGCCTTCTGGCCTTGAG
AACGCATCAACTCATTTCTGTACGCACAGT|CGGACATCTGACAGCCAAACGCATCAACTC
GAAGGATCATAAGTCGTACAGACCCAGAGT|GGTAAAGATTTCGCCATCCGCAGGACTGCG
ATACACCGGGGAAACTGTGGGATTACGATT|AGGATTCTTAAAGCTACAGAGCCTTCTGGC
CAGGGATTGCGGAGTCTCCTTGCCTGTCAT|CGCACAGTGTACGCACAGCATGTTCCAGCC
CCGGAGCCAATGAGGACGTGGCAGGGGTGC|TACGCACAGTATGTGACCTGCAATGGATAC
ACTGAACATTAACATCCGGATTCCCTCAAT|CAGCGGAGCCCAATCAATTAGGCCGGCTAA
CCTTGCCTGTCATAGCGCAATACTCATACT|GCATGTTCCAGCCGTATGGAAACGCATCAA
CACGCAATTATTTCGGTATATACGAACGAA|CCTGTATTGCATCCCGTGGTAAACTGAGGA
TCAACTCATTTCTGTACGCACAGCAGCATC|AGCAGTTTCCAAACGCATCAACTCATTTCT
TTCTGTGGTCCTTATCGTTTGGCTCTAAAC|CCTCGCCACTTGCCAGTAAGACCATAGTGA
ACGCATCAACTCATTTCTGTACGCACAAAC|ACGCACAGGTCAAGCGCCTACTGCACGTGG
CTAAATCGCGTTAACCCAAACGCATCAACT|GGAGTCTCCTTGCCTGTCATAGCGCAATAC
AGCGCAATACTCATACTTAACCTCGGCGAA|GTATGGAAACGCATCAACTCATTTCTGTAC
CGTTGGTGTAAATGCCTTGCACCTGTATTG|CAGACTGCTTAGAGCGTCCGAAGGCCAAGT
AAAGCACACAGGAGCGACCGGGAAGCGAAT|ATAGAAACGATGCGCCTAATAAAAGCCATG
CAGAGGGATTCCGGAGCCAATGAGGACGTG|CTCATTTCTGTACGCACAGTATGTGACCTG
TATTTCGGTATATACGAACGAAAAGCACAC|GCATCCCGTGGTAAACTGAGGATAGAAACG
CACAGTATGTGACCTGCAATGGATACACCG|CAACTCATTTCTGTACGCACAGAGGATTCT
ATGTCCGATCACGCTTCTTCGCCTCCGAAG|CTGTGGTCCTTATCGTTTGGCTCTAAACGC
TCTTCGCCTCCGAAGACGGCTAAACGCATC|TTTGGCTCTAAACGCATCAACTCATTTCTG
ACAGTTGTTACTGAAATGGATTAATTCTGT|AACTCATTTCTGTACGCACAGAGTCCTCGC
GCATCAACTCATTTCTGTACGCACAGGTCA|TACGATTTGCGTTGCCACTGAACATTAACA
ACGCATCAACTCATTTCTGTACGCACAGAG|TAGCGCAATACTCATACTTAACCTCGGCGA
GAGGGATTCCGGAGCCAATGAGGACGTGGC|CATTTCTGTACGCACAGTATGTGACCTGCA
CGCACAGGTCAAGCGCCTACTGCACGTGGG|GAACATTAACATCCGGATTCCCTCAATGTC
CACACCGGCAAAACGCATCAACTCATTTCT|GCTGGCCCGGGCGGACATCTGACAGCCAAA
CACAGAAACGCATCAACTCATTTCTGTACG|CGGAGCCAATGAGGACGTGGCAGGGGTGCG
GGCCGGCTAATTGTTCTCGTGCGTCGCGTA|TCTGTACGCACAGAGAAGGATCATAAGTCG
CACAGAGTCCTCGCCACTTGCCAGTAAGAC|TCGGCGAAACGCATCAACTCATTTCAAACG
ACACCGGCAAAACGCATCAACTCATTTCTG|CTGGCCCGGGCGGACATCTGACAGCCAAAC
GCACAGAACTAATGTCCGATCACGCTTCTT|ATGGATTAATTCTGTGGTCCTTATCGTTTG
ATTGCGGAGTCTCCTTGCCTGTCATAGCGC|AGTGTACGCACAGCATGTTCCAGCCGTATG
ATTTCGCCATCCGCAGGACTGCGTCGTTGG|CTGCACCAGGGAAGTAAGATAAAGCAGACT
CATAGGGTCCTAAATCGCGTTAACCCAAAC|AGGGATTGCGGAGTCTCCTTGCCTGTCATA
GGCGCCGCCAAACGCATCAACTCATTTCTG|GAAACTGTGGGATTACGATTTGCGTTGCCA
CGGCTAATTGTTCTCGTGCGTCGCGTAGCT|GTACGCACAGAGAAGGATCATAAGTCGTAC
AGCGACCGGGAAGCGAATGGGGGGACTGAG|CGCCTAATAAAAGCCATGGGTGAGTTGAAT
GCACACAGGAGCGACCGGGAAGCGAATGGG|GAAACGATGCGCCTAATAAAAGCCATGGGT
ACTCATTTCTGTACGCACAGAGGATTCTTA|CCGTCCGGCGCGTGACGTAGGTTTCAGCCC
CTCGCCACTTGCCAGTAAGACCATAGTGAC|CGCATCAACTCATTTCAAACGCATCAACTC
GCACAGTGTACGCACAGCATGTTCCAGCCG|GATCCCGGCGCCGCCAAACGCATCAACTCA
ACAGAGCCTTCTGGCCTTGAGTCACAGCGG|AACGCATCAACTCATTTCTGTACGCACAAA
CATCAACTCATTTCTGTACGCACAGAAACG|CTGTACGCACAGAGGGATTCCGGAGCCAAT
CGCCAAACGCATCAACTCATTTCTGTACGC|TGTGGGATTACGATTTGCGTTGCCACTGAA
GCTTCATGCCCTGCCCTAGTGCCGTCCGGC|TACAGACCCAGAGTCAGGTAATTAATGACC
GAGTCAGGTAATTAATGACCTGAGGTCACG|TGCGTCGTTGGTGTAAATGCCTTGCACCTG
GAAACGCATCAACTCATTTCTGTACGCACA|GCCAATGAGGACGTGGCAGGGGTGCGATCC
GGGCGGACATCTGACAGCCAAACGCATCAA|GTCGCGTAGCTTCATGCCCTGCCCTAGTGC
CATTAACATCCGGATTCCCTCAATGTCTGC|AGCCCAATCAATTAGGCCGGCTAATTGTTC
CGCCACTTGCCAGTAAGACCATAGTGACGT|CATCAACTCATTTCAAACGCATCAACTCAT
GGCGCGTGACGTAGGTTTCAGCCCGCGCAA|ACCTGAGGTCACGCAATTATTTCGGTATAT
GTCAGGTAATTAATGACCTGAGGTCACGCA|CGTCGTTGGTGTAAATGCCTTGCACCTGTA
AGGGGTGCGATCCCGGCGCCGCCAAACGCA|ATGGATACACCGGGGAAACTGTGGGATTAC
TACTTAACCTCGGCGAAACGCATCAACTCA|TCAACTCATTTCTGTACGCACAAACGCATC
TATATACGAACGAAAAGCACACAGGAGCGA|TGGTAAACTGAGGATAGAAACGATGCGCCT
CCAAACGCATCAACTCATTTCTGTACGCAC|GTCATAGCGCAATACTCATACTTAACCTCG
TAAACGCATCAACTCATTTCTGTACGCACA|GATCCCAAACACAGTTGTTACTGAAATGGA
GCCATCCGCAGGACTGCGTCGTTGGTGTAA|CCAGGGAAGTAAGATAAAGCAGACTGCTTA
TGTACGCACAGAGGGATTCCGGAGCCAATG|CGCATCAACTCATTTCTGTACGCACAGTAT
TCAACTCATTTCTGTACGCACAGAGGGATT|ACACCGGCAAAACGCATCAACTCATTTCTG
TTGCGGAGTCTCCTTGCCTGTCATAGCGCA|GTGTACGCACAGCATGTTCCAGCCGTATGG
ACGTGGGTCACACCGGCAAAACGCATCAAC|CAATGTCTGCTGGCCCGGGCGGACATCTGA
ATCCCAAACACAGTTGTTACTGAAATGGAT|AAACGCATCAACTCATTTCTGTACGCACAG
TAGGGTCCTAAATCGCGTTAACCCAAACGC|GGATTGCGGAGTCTCCTTGCCTGTCATAGC
CGTCGTTGGTGTAAATGCCTTGCACCTGTA|AAGCAGACTGCTTAGAGCGTCCGAAGGCCA
CCTGTATTGCATCCCGTGGTAAACTGAGGA|AGGCCAAGTTGGTGTCGTGGTATATGGCGA
CAAACACAGTTGTTACTGAAATGGATTAAT|GCATCAACTCATTTCTGTACGCACAGAGTC
TGACAGCCAAACGCATCAACTCATTTCTGT|TCATGCCCTGCCCTAGTGCCGTCCGGCGCG
GAACATTAACATCCGGATTCCCTCAATGTC|CGGAGCCCAATCAATTAGGCCGGCTAATTG
AAATCGCGTTAACCCAAACGCATCAACTCA|AGTCTCCTTGCCTGTCATAGCGCAATACTC
AAACGCATCAACTCATTTCTGTACGCACAG|GCGGACATCTGACAGCCAAACGCATCAACT
TCAACTCATTTCTGTACGCACAAACGCATC|CAGGTCAAGCGCCTACTGCACGTGGGTCAC
GCACAGAGGATTCTTAAAGCTACAGAGCCT|ACGTAGGTTTCAGCCCGCGCAAACGCATCA
CACAGAGAAGGATCATAAGTCGTACAGACC|TCTTTGGGTAAAGATTTCGCCATCCGCAGG
GGGAAGCGAATGGGGGGACTGAGTTCTTTG|TAAAAGCCATGGGTGAGTTGAATGCCGCAT
TGTACGCACAGGGATTGCGGAGTCTCCTTG|TTTCTGTACGCACAGTGTACGCACAGCATG
ACACAGTTGTTACTGAAATGGATTAATTCT|TCAACTCATTTCTGTACGCACAGAGTCCTC
GGATCATAAGTCGTACAGACCCAGAGTCAG|AAAGATTTCGCCATCCGCAGGACTGCGTCG
GACGGCTAAACGCATCAACTCATTTCTGTA|CATCAACTCATTTCTGTACGCACAGCAGCA
GCGGAGCCCAATCAATTAGGCCGGCTAATT|CAAACGCATCAACTCATTTCTGTACGCACA
GACGTAGCAGTTTCCAAACGCATCAACTCA|CTCATTTCTGTACGCACAGAAACGCATCAA
TGGCCCGGGCGGACATCTGACAGCCAAACG|TCGTGCGTCGCGTAGCTTCATGCCCTGCCC
ATCGTTTGGCTCTAAACGCATCAACTCATT|CAGTAAGACCATAGTGACGTAGCAGTTTCC
AACCCAAACGCATCAACTCATTTCTGTACG|CCTGTCATAGCGCAATACTCATACTTAACC
CGCACAGGCTCGGAGCGGGGAGCATGGGAT|TCCTATCCTTCATAGGGTCCTAAATCGCGT
CCCGTGGTAAACTGAGGATAGAAACGATGC|TGTCGTGGTATATGGCGAGTCTTTCGTTCT
CGCATCAACTCATTTCTGTACGCACAGAAA|TTCTGTACGCACAGAGGGATTCCGGAGCCA
ACAGCATGTTCCAGCCGTATGGAAACGCAT|CCAAACGCATCAACTCATTTCTGTACGCAC
TCTGTACGCACAGAGGATTCTTAAAGCTAC|GCGCGTGACGTAGGTTTCAGCCCGCGCAAA
GCGTTGCCACTGAACATTAACATCCGGATT|TTGAGTCACAGCGGAGCCCAATCAATTAGG
CAGTTTCCAAACGCATCAACTCATTTCTGT|CTGTACGCACAGAAACGCATCAACTCATTT
TGCGATCCCGGCGCCGCCAAACGCATCAAC|TACACCGGGGAAACTGTGGGATTACGATTT
TCTGTACGCACAGAAACGCATCAACTCATT|AGGGATTCCGGAGCCAATGAGGACGTGGCA
AGAACTAATGTCCGATCACGCTTCTTCGCC|ATTAATTCTGTGGTCCTTATCGTTTGGCTC
GCAAACGCATCAACTCATTTCTGTACGCAC|ATATACGAACGAAAAGCACACAGGAGCGAC
CGGAGCCAATGAGGACGTGGCAGGGGTGCG|ACGCACAGTATGTGACCTGCAATGGATACA
AGGGATTCCGGAGCCAATGAGGACGTGGCA|ATTTCTGTACGCACAGTATGTGACCTGCAA
ATCAATTAGGCCGGCTAATTGTTCTCGTGC|AACTCATTTCTGTACGCACAGAGAAGGATC
TTAATGACCTGAGGTCACGCAATTATTTCG|TGTAAATGCCTTGCACCTGTATTGCATCCC
GCGATCCCGGCGCCGCCAAACGCATCAACT|ACACCGGGGAAACTGTGGGATTACGATTTG
GGAGCCCAATCAATTAGGCCGGCTAATTGT|AACGCATCAACTCATTTCTGTACGCACAGA
TGGTGTAAATGCCTTGCACCTGTATTGCAT|ACTGCTTAGAGCGTCCGAAGGCCAAGTTGG
AACGCATCAACTCATTTCTGTACGCACAGG|CAGAAACGCATCAACTCATTTCTGTACGCA
CGAGATCCCAAACACAGTTGTTACTGAAAT|ACCCAAACGCATCAACTCATTTCTGTACGC
ACTCATTTCTGTACGCACAGTATGTGACCT|GACAGCCAAACGCATCAACTCATTTCTGTA
AAGCACACAGGAGCGACCGGGAAGCGAATG|TAGAAACGATGCGCCTAATAAAAGCCATGG
CGCAAACGCATCAACTCATTTCTGTACGCA|TATATACGAACGAAAAGCACACAGGAGCGA
CAAAACGCATCAACTCATTTCTGTACGCAC|GGGCGGACATCTGACAGCCAAACGCATCAA
GATTCCCTCAATGTCTGCTGGCCCGGGCGG|TAGGCCGGCTAATTGTTCTCGTGCGTCGCG
ATTGCATCCCGTGGTAAACTGAGGATAGAA|AAGTTGGTGTCGTGGTATATGGCGAGTCTT
AGAGAAGGATCATAAGTCGTACAGACCCAG|TTGGGTAAAGATTTCGCCATCCGCAGGACT
TCCGATCACGCTTCTTCGCCTCCGAAGACG|TGGTCCTTATCGTTTGGCTCTAAACGCATC
CTACTGCACGTGGGTCACACCGGCAAAACG|ATTCCCTCAATGTCTGCTGGCCCGGGCGGA
CAGAGGATTCTTAAAGCTACAGAGCCTTCT|TAGGTTTCAGCCCGCGCAAACGCATCAACT
CCCTCAATGTCTGCTGGCCCGGGCGGACAT|CCGGCTAATTGTTCTCGTGCGTCGCGTAGC
GTACGCACAGGCTCGGAGCGGGGAGCATGG|GCATCCTATCCTTCATAGGGTCCTAAATCG
CTGGCCCGGGCGGACATCTGACAGCCAAAC|CTCGTGCGTCGCGTAGCTTCATGCCCTGCC
TAGGTTTCAGCCCGCGCAAACGCATCAACT|CGCAATTATTTCGGTATATACGAACGAAAA
GCTCTAAACGCATCAACTCATTTCTGTACG|CCATAGTGACGTAGCAGTTTCCAAACGCAT
CGCACAGAGGGATTCCGGAGCCAATGAGGA|TCAACTCATTTCTGTACGCACAGTATGTGA
AAACGCATCAACTCATTTCTGTACGCACAA|GTACGCACAGGTCAAGCGCCTACTGCACGT
GTACGCACAGGTCAAGCGCCTACTGCACGT|ACTGAACATTAACATCCGGATTCCCTCAAT
ATAAACGCATCAACTCATTTCTGTACGCAC|AGATCCCAAACACAGTTGTTACTGAAATGG
TTAAAGCTACAGAGCCTTCTGGCCTTGAGT|CCCGCGCAAACGCATCAACTCATTTCTGTA
AGGTAATTAATGACCTGAGGTCACGCAATT|CGTTGGTGTAAATGCCTTGCACCTGTATTG
CTCATTTCTGTACGCACAGCAGCATCCTAT|GTTTCCAAACGCATCAACTCATTTCTGTAC
TCGCGTAGCTTCATGCCCTGCCCTAGTGCC|TAAGTCGTACAGACCCAGAGTCAGGTAATT
CGTTGCCACTGAACATTAACATCCGGATTC|TGAGTCACAGCGGAGCCCAATCAATTAGGC
CTCATTTCTGTACGCACAGTGTACGCACAG|GTGGCAGGGGTGCGATCCCGGCGCCGCCAA
GGTAAACTGAGGATAGAAACGATGCGCCTA|TGGTATATGGCGAGTCTTTCGTTCTAATAG
GTACGCACAGAAACGCATCAACTCATTTCT|GATTCCGGAGCCAATGAGGACGTGGCAGGG
CTAGTGCCGTCCGGCGCGTGACGTAGGTTT|AGGTAATTAATGACCTGAGGTCACGCAATT
CCTCCGAAGACGGCTAAACGCATCAACTCA|TCTAAACGCATCAACTCATTTCTGTACGCA
TTCCAGCCGTATGGAAACGCATCAACTCAT|ATCAACTCATTTCTGTACGCACAGGTCAAG
AACTCATTTCTGTACGCACAGGTCAAGCGC|TTTGCGTTGCCACTGAACATTAACATCCGG
TCATTTCTGTACGCACAGGGATTGCGGAGT|CAACTCATTTCTGTACGCACAGTGTACGCA
GTACGCACAGAGGGATTCCGGAGCCAATGA|GCATCAACTCATTTCTGTACGCACAGTATG
AAACGCATCAACTCATTTCTGTACGCACAG|GTGACGTAGCAGTTTCCAAACGCATCAACT
CAACTCATTTCTGTACGCACAGAGTCCTCG|AATACTCATACTTAACCTCGGCGAAACGCA
ATCAACTCATTTCTGTACGCACAGAGTCCT|GCAATACTCATACTTAACCTCGGCGAAACG
GTCACAGCGGAGCCCAATCAATTAGGCCGG|TACGCACAAACGCATCAACTCATTTCTGTA
TGTCTGCTGGCCCGGGCGGACATCTGACAG|ATTGTTCTCGTGCGTCGCGTAGCTTCATGC
TTAACATCCGGATTCCCTCAATGTCTGCTG|CCCAATCAATTAGGCCGGCTAATTGTTCTC
ACTCATTTCTGTACGCACAGGTCAAGCGCC|TTGCGTTGCCACTGAACATTAACATCCGGA
GGCTCTAAACGCATCAACTCATTTCTGTAC|ACCATAGTGACGTAGCAGTTTCCAAACGCA
CGCACAGCAGCATCCTATCCTTCATAGGGT|ATCAACTCATTTCTGTACGCACAGGGATTG
ACAGGAGCGACCGGGAAGCGAATGGGGGGA|CGATGCGCCTAATAAAAGCCATGGGTGAGT
TTTCTGTACGCACAGAGGATTCTTAAAGCT|CGGCGCGTGACGTAGGTTTCAGCCCGCGCA
CGGAGTCTCCTTGCCTGTCATAGCGCAATA|TACGCACAGCATGTTCCAGCCGTATGGAAA
TCAACTCATTTCAAACGCATCAACTCATTT|AACGCATCAACTCATTTCTGTACGCACAGA
TGGGGGGACTGAGTTCTTTGGGTAAAGATT|GGGTGAGTTGAATGCCGCATCAAGACCCTG
CGCACAAACGCATCAACTCATTTCTGTACG|GCGACCGGGAAGCGAATGGGGGGACTGAGT
TTTCCAAACGCATCAACTCATTTCTGTACG|TACGCACAGAAACGCATCAACTCATTTCTG
ACGCATCAACTCATTTCTGTACGCACAGCA|GACGTAGCAGTTTCCAAACGCATCAACTCA
GCCTCCGAAGACGGCTAAACGCATCAACTC|CTCTAAACGCATCAACTCATTTCTGTACGC
CGGAGCCCAATCAATTAGGCCGGCTAATTG|AAACGCATCAACTCATTTCTGTACGCACAG
GCCCAATCAATTAGGCCGGCTAATTGTTCT|GCATCAACTCATTTCTGTACGCACAGAGAA
AACGCATCAACTCATTTCTGTACGCACAAA|TACGAACGAAAAGCACACAGGAGCGACCGG
CCGGGCGGACATCTGACAGCCAAACGCATC|GCGTCGCGTAGCTTCATGCCCTGCCCTAGT
TTCATAGGGTCCTAAATCGCGTTAACCCAA|ACAGGGATTGCGGAGTCTCCTTGCCTGTCA
CAGAAACGCATCAACTCATTTCTGTACGCA|GAGCCAATGAGGACGTGGCAGGGGTGCGAT
CATTTCTGTACGCACAGGGATTGCGGAGTC|AACTCATTTCTGTACGCACAGTGTACGCAC
ATGCCTTGCACCTGTATTGCATCCCGTGGT|GAGCGTCCGAAGGCCAAGTTGGTGTCGTGG
GATCCCGAGATCCCAAACACAGTTGTTACT|CGTTAACCCAAACGCATCAACTCATTTCTG
GAAGCGAATGGGGGGACTGAGTTCTTTGGG|AAAGCCATGGGTGAGTTGAATGCCGCATCA
ACAGCGGAGCCCAATCAATTAGGCCGGCTA|GCACAAACGCATCAACTCATTTCTGTACGC
GTGACGTAGCAGTTTCCAAACGCATCAACT|AACTCATTTCTGTACGCACAGAAACGCATC
ACGCATCAACTCATTTCTGTACGCACAGGT|ATTACGATTTGCGTTGCCACTGAACATTAA
AATGTCCGATCACGCTTCTTCGCCTCCGAA|TCTGTGGTCCTTATCGTTTGGCTCTAAACG
CAAACGCATCAACTCATTTCTGTACGCACA|CACAGAAACGCATCAACTCATTTCTGTACG
TGACGTAGCAGTTTCCAAACGCATCAACTC|ACTCATTTCTGTACGCACAGAAACGCATCA
CGAATGGGGGGACTGAGTTCTTTGGGTAAA|CCATGGGTGAGTTGAATGCCGCATCAAGAC
CAACTCATTTCTGTACGCACAGTGTACGCA|GACGTGGCAGGGGTGCGATCCCGGCGCCGC
AACTCATTTCTGTACGCACAGAACTAATGT|ACAGTTGTTACTGAAATGGATTAATTCTGT
CTCATTTCTGTACGCACAAACGCATCAACT|AAGCACACAGGAGCGACCGGGAAGCGAATG
CTGGCCTTGAGTCACAGCGGAGCCCAATCA|CTCATTTCTGTACGCACAAACGCATCAACT
AAGTCGTACAGACCCAGAGTCAGGTAATTA|TCGCCATCCGCAGGACTGCGTCGTTGGTGT
AGTGTACGCACAGCATGTTCCAGCCGTATG|CCGGCGCCGCCAAACGCATCAACTCATTTC
GACAGCCAAACGCATCAACTCATTTCTGTA|CATGCCCTGCCCTAGTGCCGTCCGGCGCGT
CCGGGAAGCGAATGGGGGGACTGAGTTCTT|AATAAAAGCCATGGGTGAGTTGAATGCCGC
TACGCACAGAGTCCTCGCCACTTGCCAGTA|AACCTCGGCGAAACGCATCAACTCATTTCA
TCATTTCTGTACGCACAGAGAAGGATCATA|GGGGGGACTGAGTTCTTTGGGTAAAGATTT
TTGCGTTGCCACTGAACATTAACATCCGGA|CCTTGAGTCACAGCGGAGCCCAATCAATTA
CTTGCCAGTAAGACCATAGTGACGTAGCAG|ACTCATTTCAAACGCATCAACTCATTTCTG
ACTGAAATGGATTAATTCTGTGGTCCTTAT|CTGTACGCACAGAGTCCTCGCCACTTGCCA
CGGCTAAACGCATCAACTCATTTCTGTACG|TCAACTCATTTCTGTACGCACAGCAGCATC
TCATTTCTGTACGCACAGAGGATTCTTAAA|GTCCGGCGCGTGACGTAGGTTTCAGCCCGC
CAGCAGCATCCTATCCTTCATAGGGTCCTA|ACTCATTTCTGTACGCACAGGGATTGCGGA
TTTCAGCCCGCGCAAACGCATCAACTCATT|ATTATTTCGGTATATACGAACGAAAAGCAC
CGATAAACGCATCAACTCATTTCTGTACGC|CGAGATCCCAAACACAGTTGTTACTGAAAT
CGGGAAGCGAATGGGGGGACTGAGTTCTTT|ATAAAAGCCATGGGTGAGTTGAATGCCGCA
CTCTAAACGCATCAACTCATTTCTGTACGC|CATAGTGACGTAGCAGTTTCCAAACGCATC
AACTCATTTCTGTACGCACAGAGGGATTCC|ACCGGCAAAACGCATCAACTCATTTCTGTA
GCTCGGAGCGGGGAGCATGGGATCCCGAGA|CTTCATAGGGTCCTAAATCGCGTTAACCCA
TAAAGCTACAGAGCCTTCTGGCCTTGAGTC|CCGCGCAAACGCATCAACTCATTTCTGTAC
ATTATTTCGGTATATACGAACGAAAAGCAC|TTGCATCCCGTGGTAAACTGAGGATAGAAA
GTACGCACAGGGATTGCGGAGTCTCCTTGC|TTCTGTACGCACAGTGTACGCACAGCATGT
AACGCATCAACTCATTTCTGTACGCACAGG|GATTACGATTTGCGTTGCCACTGAACATTA
CTCATTTCTGTACGCACAGAGGGATTCCGG|CGGCAAAACGCATCAACTCATTTCTGTACG
ACTCATACTTAACCTCGGCGAAACGCATCA|ACGCATCAACTCATTTCTGTACGCACAAAC
CGCATCAACTCATTTCTGTACGCACAGCAG|ACGTAGCAGTTTCCAAACGCATCAACTCAT
ACGCATCAACTCATTTCTGTACGCACAGGG|AGAAACGCATCAACTCATTTCTGTACGCAC
GCAGGACTGCGTCGTTGGTGTAAATGCCTT|AGTAAGATAAAGCAGACTGCTTAGAGCGTC
GATTCCGGAGCCAATGAGGACGTGGCAGGG|TCTGTACGCACAGTATGTGACCTGCAATGG
TCAATGTCTGCTGGCCCGGGCGGACATCTG|GCTAATTGTTCTCGTGCGTCGCGTAGCTTC
GGGTCCTAAATCGCGTTAACCCAAACGCAT|ATTGCGGAGTCTCCTTGCCTGTCATAGCGC
AAGCTACAGAGCCTTCTGGCCTTGAGTCAC|GCGCAAACGCATCAACTCATTTCTGTACGC
AACGCATCAACTCATTTCTGTACGCACAGG|CATTTCTGTACGCACAGCAGCATCCTATCC
AAACTGTGGGATTACGATTTGCGTTGCCAC|AGCTACAGAGCCTTCTGGCCTTGAGTCACA
TCAACTCATTTCTGTACGCACAGAAACGCA|GTACGCACAGAGGGATTCCGGAGCCAATGA
ACTCATTTCAAACGCATCAACTCATTTCTG|GCATCAACTCATTTCTGTACGCACAGAGGG
CATCCGGATTCCCTCAATGTCTGCTGGCCC|ATCAATTAGGCCGGCTAATTGTTCTCGTGC
CCGGATTCCCTCAATGTCTGCTGGCCCGGG|AATTAGGCCGGCTAATTGTTCTCGTGCGTC
GGCGAAACGCATCAACTCATTTCAAACGCA|CTGTACGCACAAACGCATCAACTCATTTCT
TCCGAAGACGGCTAAACGCATCAACTCATT|TAAACGCATCAACTCATTTCTGTACGCACA
GTGGTAAACTGAGGATAGAAACGATGCGCC|CGTGGTATATGGCGAGTCTTTCGTTCTAAT
CATGTTCCAGCCGTATGGAAACGCATCAAC|ACGCATCAACTCATTTCTGTACGCACAGGT
CGGCGAAACGCATCAACTCATTTCAAACGC|TCTGTACGCACAAACGCATCAACTCATTTC
GAGAAGGATCATAAGTCGTACAGACCCAGA|TGGGTAAAGATTTCGCCATCCGCAGGACTG
CAACTCATTTCTGTACGCACAAACGCATCA|AGGTCAAGCGCCTACTGCACGTGGGTCACA
CTATCCTTCATAGGGTCCTAAATCGCGTTA|GTACGCACAGGGATTGCGGAGTCTCCTTGC
CTGTACGCACAGTGTACGCACAGCATGTTC|GGGTGCGATCCCGGCGCCGCCAAACGCATC
GAGTCTCCTTGCCTGTCATAGCGCAATACT|CGCACAGCATGTTCCAGCCGTATGGAAACG
GTAGCTTCATGCCCTGCCCTAGTGCCGTCC|TCGTACAGACCCAGAGTCAGGTAATTAATG
AGCGGGGAGCATGGGATCCCGAGATCCCAA|AGGGTCCTAAATCGCGTTAACCCAAACGCA
CCCGAGATCCCAAACACAGTTGTTACTGAA|TAACCCAAACGCATCAACTCATTTCTGTAC
CATTTCTGTACGCACAGTGTACGCACAGCA|GGCAGGGGTGCGATCCCGGCGCCGCCAAAC
ACCTGCAATGGATACACCGGGGAAACTGTG|TGTACGCACAGAGGATTCTTAAAGCTACAG
TGGCTCTAAACGCATCAACTCATTTCTGTA|GACCATAGTGACGTAGCAGTTTCCAAACGC
ACGCACAGAGGATTCTTAAAGCTACAGAGC|TGACGTAGGTTTCAGCCCGCGCAAACGCAT
AACTCATTTCTGTACGCACAGAAACGCATC|ACGCACAGAGGGATTCCGGAGCCAATGAGG
AACGCATCAACTCATTTCTGTACGCACAGA|TCCCAAACACAGTTGTTACTGAAATGGATT
CCCTGCCCTAGTGCCGTCCGGCGCGTGACG|CAGAGTCAGGTAATTAATGACCTGAGGTCA
GACCTGAGGTCACGCAATTATTTCGGTATA|ATGCCTTGCACCTGTATTGCATCCCGTGGT
CAACTCATTTCTGTACGCACAGAGGGATTC|CACCGGCAAAACGCATCAACTCATTTCTGT
ACGCATCAACTCATTTCTGTACGCACAGTG|AATGAGGACGTGGCAGGGGTGCGATCCCGG
GCACAAACGCATCAACTCATTTCTGTACGC|GCACGTGGGTCACACCGGCAAAACGCATCA
ACGCACAGCAGCATCCTATCCTTCATAGGG|CATCAACTCATTTCTGTACGCACAGGGATT
CACAGTGTACGCACAGCATGTTCCAGCCGT|ATCCCGGCGCCGCCAAACGCATCAACTCAT
ACACAGGAGCGACCGGGAAGCGAATGGGGG|AACGATGCGCCTAATAAAAGCCATGGGTGA
TGTTCTCGTGCGTCGCGTAGCTTCATGCCC|AGAGAAGGATCATAAGTCGTACAGACCCAG
TTATTTCGGTATATACGAACGAAAAGCACA|TGCATCCCGTGGTAAACTGAGGATAGAAAC
CATGCCCTGCCCTAGTGCCGTCCGGCGCGT|GACCCAGAGTCAGGTAATTAATGACCTGAG